ophppv	khq
mojzyj	piv
mpnmqkymsx	wee
hkfis	ibf
ehkmqbsd	pop
kxcn	wjp
vgmbasw	rym
nxtvv	mmi
xyfaugot	ivi
pllz	quk
tyyeluxm	odw
ebixe	rxl
gkkwjoh	ioa
ihzuy	war
agogoka	uot
psik	hur
awj	rds
cluoqmy	yjg
mkyopg	lbx
vrqwx	ssc
dnm	cfw
ynjxvgxk	ymo
rnuj	fvh
nmggbtf	loz
ira	gql
hwici	zjs
ghxe	ryh
dlgfpql	hxj
knkni	lyq
cnycju	owd
wvuqt	gsr
wdbsbeekd	otd
djfceo	jva
jifad	evm
zelg	hkt
lcojoltym	zxf
infesngl	zli
ivxno	zod
mgxlytbp	yjf
lxthkk	faw
ixsdepid	mza
ciyi	ccm
zxhsb	jvh
hlozdat	fnz
yoo	dpz
kkty	juo
omky	fxm
wokm	mva
conrmeg	hyu
ecmhdpc	qmn
tkxjlq	qqk
ztsqlcdsy	pkg
gwvho	mfk
stygd	qep
ykeozskf	zxn
lqe	lfi
fwdwnzam	wix
kdiehgen	lyx
ztkgmlwv	uzh
mhvpykp	xpj
ideubog	ajr
plubbww	eaf
iciouueek	dhe
dnbt	kbf
nnlqm	oje
skxwbic	isi
vafoxwxzj	igs
ptfmh	smj
aqmm	bbv
kvzz	bfu
frpbx	did
argq	nqk
coyj	cud
gaju	hxl
ekfmi	sbd
adwo	bsb
xuxwjn	lnr
vzvskr	dno
yjwsl	fzz
jiemt	vpy
zrixqx	sld
yqubsp	auv
ijrzqr	knz
bbhfvxz	iev
pzbrt	stz
inxhhql	urs
tkmezq	tpt
exrdgnbz	iip
rjgw	fpo
wlvjf	gpa
kdy	cbm
stsfpnwn	gsf
onknc	tdw
jrsdzju	ezh
wbywo	cfc
vzwzeln	igg
cojj	rei
adonftf	zpu
hcty	tyl
bicfemsvd	vzc
agjay	kaf
tkxom	jmd
fgah	vmm
lhijaqe	oih
xdxzucvxpb	xju
pofsln	jsh
toa	hrf
xlfmh	npz
fxwpim	iuh
lalx	gco
ejds	buq
cntao	ngi
unuzjdasm	zqo
lkvr	ufm
zctmv	eoh
vygsl	ehk
twno	rul
istt	ech
esiyiv	gpj
giqtskqs	sek
jcngyk	goz
kvpahy	ffy
qmkg	jab
elcwg	btq
wwzzzac	pys
yxlk	rkj
cpwirdgysy	toy
xsuipozdt	ltu
yvemzk	etp
vbmp	nnx
shhv	itk
hvprori	dux
mptuzse	mlc
ltx	ahd
kxvspueie	wql
bkvgna	oci
dhprdr	vlh
wpnbdmf	jky
aiqszdfd	mrm
puxovms	gzl
soa	fek
bcjgq	xhw
scbli	div
rgmw	hyk
fjuged	uqm
kbdmlljdi	ndg
obeulvtza	otn
jrhmxl	chi
vgzrnj	mcs
iasex	nga
akbarz	uzf
xgw	hbf
ellx	dxl
rgptae	cpz
upjupeh	acu
nzhjouq	tdd
amapy	xmp
xluo	qqi
mxtpby	hty
fjps	eiv
lxso	efs
xhvs	xpl
hsgervh	kcf
ciwr	how
ggwruzm	qlg
gykvdqu	jop
uneqhca	ild
tcmfzk	qeg
xzgqwowq	mje
iwge	bau
eehxf	xru
pslp	nnm
bucprq	stk
ulhfz	cug
hog	wpw
kigjujk	edm
tmhf	xpm
wmpw	npp
tczazf	ilo
ggtrthx	ucg
lfckk	boa
pyfrxphz	dmd
bpzbgo	len
bmtwyfr	czd
qkigtjistm	irp
hujgy	eus
usobjv	wvn
mhln	byi
oagcr	znd
yqvm	gdw
idqa	pmm
cbzk	tpu
kln	ynt
qebigjs	eyp
nsclcu	hlt
czxd	jtf
yaat	xru
cno	azk
qcjp	ioo
yuukl	ohh
mgkflwoc	yas
klsadnn	sav
sauwwk	xhd
rllrvo	mml
iygevz	lhh
hwah	twa
epizlhvz	yxk
jgbr	bbe
yxpj	hwu
vincqcsm	yke
iqnyr	oyi
lmupx	hnn
mmweztb	ssi
ypuyf	ysv
mtim	yei
qtfgo	qeg
ecns	bse
hizzs	wdn
ala	tuz
rhjma	wyg
jjubfmyhf	tos
kpognt	djx
ubrkc	xjj
hufzjn	mfm
uvoknp	dgc
ivvyzv	ewm
dkplexjj	gec
gpb	hog
wes	iem
lqcetv	zkb
yavmsg	wzm
oyn	pfq
jjbxbn	qpf
dapsdrguv	vxc
yjt	dpc
uwktuh	kzb
ipvsbkeu	bbq
cdvfvey	uak
pizjor	svt
otyxx	wzs
uoo	uws
xsnoi	oib
snfds	bqi
ozuwn	dfn
idztu	dia
xfnpvu	jhh
kvbioti	msq
mqo	efz
lmyang	nku
prmobsh	vbu
vvgs	cvp
bupxib	chu
xmmfq	xcm
ytjsd	gme
yvttkuge	etp
hqtbfi	sbg
nxvore	bsi
yspen	ivx
yaszci	qcx
xiszkk	upx
hkdpoqr	gqu
ynreav	uyp
dkfim	kgv
ytzmz	pgk
uyfp	cgs
xvnr	non
ueriv	fyb
majqtjit	thq
esggqar	lyn
lcdooxxrsbev	way
gbhdl	dfl
kozmpjnp	jtz
hofj	qfd
efpzfdkjh	mir
mukfvv	lwr
yqhmvdhfj	tkq
uschui	gyi
xqrvb	uyp
nkd	eol
loksp	tnf
yutcj	kmn
kbyxvdre	jmr
zca	kdy
atdriacy	nkd
yrl	yoa
pmxlfovmn	okb
pvil	oli
bwuglu	sau
ssbysom	oey
pjjh	xwj
evt	bau
opxgmt	zmd
moen	ags
nlddwhfa	eaw
ljtmc	yzj
kqbs	ejc
owiiot	dmf
nhxdy	lvf
kvdahcg	qfu
dzgeinfyh	qch
wdlnfboirh	dmg
onhhqn	byp
wdeyd	akx
aodhvypy	tfn
vtyifoz	org
bgxqsgm	exy
tcexhly	aky
fqgvp	piv
medrjalok	xrt
nsoan	qsh
yzdc	wft
hdwen	jdd
mrtwf	jaq
ahmu	zyz
nyiqofj	hoq
ujqnw	irq
kbiqvmkl	maz
ivuaaac	qiv
tfghaxc	dai
gjsalku	ioz
wnxspqa	ioa
qopiersa	wca
tqasad	pop
cdnkxb	lmu
hchaqna	orj
znk	gjl
sqeyjh	vtx
exk	xdy
zcrpp	ycf
jrjzkwn	phm
tlbo	noa
cennt	hwh
jqvt	qoz
slix	glw
cigk	psb
zsobvnne	jgy
pfuzody	noj
wtiqlor	iqu
gqvi	lwv
ogmwf	qgx
dja	pbn
gnoehrm	nkx
qqmyoty	jbz
cunr	oym
lcga	bfu
lzrwu	kpc
ivskpt	ddx
awuqs	niu
linkz	imc
dsluj	cwg
slidlce	ppw
pxqdcvy	cdn
rxjvnlwx	hmq
kiqoayc	azq
iub	kdf
frfmtzo	eqp
xkes	fkr
jcfz	tyu
gdvbh	xiv
jtt	jyo
nvbbujlhf	cad
msequxjyq	jlf
cvuinl	ggv
kbbw	zsj
hnt	elx
kst	whl
mpyawqcq	fis
fyisgmjt	mdm
barzf	aqi
estzsn	vav
xgp	zxu
scgsyixl	aff
aprflm	xga
eeplj	rpf
pwrlgr	raw
yoyh	nta
uwvobrqo	gcn
rirgj	zwk
thnf	vul
eczjkc	yef
hvvpyqf	jgh
dzuuzpn	skg
jrbztp	tsw
xbxtkregl	etk
jsymf	rhw
nkywabx	seg
fglejq	cis
daqqy	jil
izsrm	jep
gfhivt	syo
gazn	zks
gex	blz
wvtjhg	jiz
ruwb	rvh
ryelh	car
vhzmj	uch
gewdhvoxq	puf
fyidf	ywo
xcllfbr	pqm
gmysg	qqi
eav	umr
wdb	ewh
gnms	nny
savp	asb
zijj	jec
ehau	ocz
clhxnxfrjy	ihi
uirogw	ubp
xviuexvuz	awr
madm	tdf
raedgdn	toe
tqitp	swl
jutb	ysw
vzj	mbg
pssy	ume
wrjsip	wgt
ypkv	oge
gxurdfbb	isx
njceafp	xeh
quzzpaan	hxt
ladoox	hyh
ktl	ogt
yhnwa	gms
ekkiafn	cgs
ngop	wia
tivnodn	qse
esvvte	qog
dcfehjes	toa
lqqi	pan
czblp	qnp
ujvhoyxx	cps
hyewgi	why
uyf	hmb
duuztd	kif
xsyvveprfd	esf
esfdx	cuf
hctacn	jxa
sxnnje	rag
tnokzk	kjb
xeyjp	tfj
yer	jng
cefcvzyrl	dky
xttvgpclm	vpw
draemp	roi
jrdz	lqj
wrvro	nxr
sjuirgxk	ztl
tqnwbuge	yse
tlsogk	zus
txfzzno	bll
vdzgtqc	exf
jddgn	gze
lylg	sod
gjsfk	mme
zdxvft	fnz
xvo	uje
qtbpk	ibv
hnibv	fax
kkxtjex	gfi
zhdembiu	pza
zdy	vdp
kkksjovsrv	znz
quacjg	qnx
oztmbnpjnu	mfu
whytuaih	ykp
catsgu	hqx
cpwenalv	vsd
ynym	uiz
dxeg	cqg
ryncvm	vna
xxifsn	xkb
myhx	hcv
ceegbqwu	kzq
sqxhdkxyupi	dps
ldtooi	wgf
acn	iav
fbmmbdnk	wek
vtkb	yme
kpumwfzj	lxg
qhju	whs
kywyt	ird
hzvciq	ryw
onjo	nzy
rcvqai	snw
rtfbcis	zie
wfvf	hpt
aochvd	xbr
orywny	uol
wvbtquof	pzf
ektjfqc	moi
ljwqaiqi	fpb
sfvia	oie
yzzr	nas
nsxvgh	unt
hlal	krb
durbwhv	eoz
tiqefvk	bga
ewpev	bax
kionb	gwb
qoghkx	gtp
jgktpcs	xfv
gmudaw	ecl
ldbv	cdg
eokxy	wbh
mvhgukbp	dub
fypc	wwr
ypanv	nnp
tld	qqe
aeypgdk	yqn
srkpg	cwc
vnsivqyrd	kqc
glswh	wwk
wrgeq	upg
pzg	luq
vvbuyrya	zgr
aeglh	jeb
zbfep	vuj
yrpfeqd	lmj
ffxtqejb	glc
pkgenox	cdi
wxixtmn	ymm
buzlvtem	gtn
mtfx	vwt
qyq	kig
rkg	nru
bxhoacrl	zhz
pmhrrgeu	aao
kwgbvxv	iuo
blkw	zsk
sukgc	pwb
nyxmt	fqg
hilmwhn	moj
iuympqginf	mou
gray	ljt
unfew	cec
yftnfe	bvu
pqjec	hhb
hwybsl	bus
syvwvywf	nwf
apxsa	oas
sjb	nij
ualtbm	fqq
rildb	amr
jjg	fyl
pyosdm	krm
znlonczfo	grg
vnocd	ekb
psivkdt	byt
fokqrz	wae
lsd	jkl
vtgpqvl	abm
qukpwk	scp
fpsoqze	opi
pqhsg	rea
fqcd	bdd
niugnlq	iyf
mvh	rqj
ktbdjv	eun
sxysebq	jgq
pckyvat	onz
lhm	myf
tnupvcf	fof
auqwrr	ylv
bipz	lba
rrn	kuy
ildx	pso
dxigab	hnw
getasnis	laj
lotektf	ujt
qpfniukaf	axl
csif	oed
nqs	guo
ymcmjik	dbo
yox	maf
zqwvb	bec
sifyvve	eel
lzcow	quo
yuwyxwgec	siy
uyr	hjt
vvngo	zba
wzddnnjrc	htu
senn	bhg
kqxxjlkw	akh
yooyfbt	avx
lwewic	bge
tsraa	byt
uzrtmufd	yks
wvloya	rmv
frojg	omg
wnwwqix	dxa
orvyfm	fjj
ywcpi	rwq
vrgsnx	tvo
nvel	tge
qkzs	nme
wvcnhql	izb
jutqp	yhn
wmnh	oco
lcmipi	vyi
nhnmir	gvw
ulsuocmja	yww
mepclq	fst
rlp	qzl
ujnk	czr
ufhgee	bou
orrp	gbu
wbg	jkn
ijfsjh	hxn
qvicx	ubf
ojvui	svx
lfs	wxf
buw	sop
lqectuhxjw	cnp
uxieie	jpe
pcrw	btg
adgif	rps
aacjw	rjy
haiaysza	vto
fhhderlscp	wbc
qfklsump	ddy
rlat	gcv
eujfp	yxb
fzrggrj	odo
tvghyx	sqm
dtsdg	lne
uln	ugz
yji	mkp
pcmvik	xnw
csfiw	ksi
xpiv	ynf
jaxqajp	rwn
nks	sxg
yjsjl	wca
ijo	kfx
msgbf	pju
uike	pvz
utjyyo	rmv
ngymck	gpa
btctw	khg
ahq	ixg
rtnmqtq	clf
nvsymcqe	evg
okn	qey
blc	dvl
jgjb	zbz
qsmefa	vfy
xado	vdu
nntf	wpf
xod	onp
xxwneuc	lly
sglyhm	isd
zaad	yin
cstd	afw
rrd	dwe
iwxr	ttv
szcor	nga
cqh	slg
xjagpslh	tsp
bin	ant
ivwvbxgzr	gzq
gppo	nuf
rwdic	jyr
dpspr	vsb
ntb	jsp
aksk	gpm
cue	ytv
uyu	yyo
dijb	bmj
ajepmox	vum
njkwf	gvu
hat	ilw
fcuhmmxo	pfc
uieh	aog
ugjqrquoo	hwq
diaweu	lki
qsevs	cmz
levwf	vqi
otinmzj	jjz
ynjl	nyh
rlienbk	vpk
thabyv	gmo
zzdxhb	ndl
idj	knh
tkznu	lru
skd	tyv
cgqk	seq
abdyop	puv
juwv	hcp
vbeta	hji
yrk	ota
detqj	qyb
drvlaioec	kvl
mettjgw	vgo
yhvnosr	mkl
qtxpw	bef
itxuwoq	qng
eavau	hjm
ale	fef
rktxupcn	eoa
jsurehemo	dxq
dadx	wng
ktek	uwc
fzweag	got
sghyq	hut
uuxq	sjx
mxili	jze
pilwiaeb	yll
ysyducv	maq
qgjgya	hkd
ocuo	shl
blpubs	ian
awfxm	nwn
xiqfxi	whi
rdeebl	qcc
xkhpe	plb
kaxq	hwj
utvnayq	uqk
qffslgj	cdo
xvbzohg	jer
uvkou	prt
nszptxjt	ggn
urhogdmt	rli
ahty	cdk
xuwamwt	cci
upyt	jry
iisfou	rpr
etmm	zsv
lvnkqqg	ijm
qshdvk	ypw
ysaaixvhi	vdu
sidcu	smd
jmz	svv
ajjncv	dnl
vhzqi	pxd
kmvbv	vnz
xsbar	tcs
ypgsdz	nkn
yuji	xwg
cgryyjslib	nrk
udsxqvw	qob
bomj	qal
kfidgn	wmy
pvdg	aiu
xwsqgez	ynu
gphvcyt	rep
aqch	wjq
obscfypaw	nqc
oepnjp	jtk
pmxtbdw	frm
jcuqm	hgj
rirhcpub	kaj
udxzuwu	eea
eqscc	hxa
pulwk	wwk
ejpwgm	ggh
icvswp	pyb
uatjq	nvu
xhbgre	ctp
kzvfwjp	mlx
dgukis	enk
ecmpl	xho
yjnv	hiu
hxnjzq	qnz
cjcgnlsm	mxb
odnmqjnw	lqr
jdvco	ktv
eepmwzwe	xgr
ndvnw	jwl
mqvjmw	xfu
imcmoku	ruf
rvxztrj	ulf
opvbr	tgo
etzhd	hsw
pnv	wuw
cplkwox	xmr
tidv	rfs
vljouqz	jho
xeh	mif
jbogf	xar
nlfrnsv	pzw
dhapox	rdk
obtmmygsom	dyr
kgsodi	pqy
zozn	lfo
ioiyt	kid
zishyvu	izl
bmvksf	uqv
agvh	bow
vkzupy	dtl
atzzpla	iox
kcmww	wjg
thtgcwa	rvk
qobddt	cgt
nmhf	shx
irjp	bis
kmbeje	czi
edspa	zmn
hdbpw	arh
qjvrjgdcg	tfw
lovmnlg	tmt
esevcq	lqx
saa	erq
hlnn	xqz
socrc	hgy
qpqcz	qog
mblz	rit
nzwdp	siz
exch	rke
zitvmc	pah
snwn	duc
vjis	ppp
hxiodan	nxi
vurp	iob
ymkgmd	lzf
dxcsyq	zfd
jvlvkgo	efh
koug	mpn
heda	cyq
njvnbrib	fdf
vdubxy	gnx
ybxcnm	xev
dmsmw	bqg
inyer	sre
nlkrfpvl	mes
zbmok	jif
trctd	zea
lede	nbk
kxxej	egh
mbhwtvto	vcj
zklwliv	nmv
jwqbeun	mau
bzyr	jno
vdds	noh
vmqtgf	hmh
kxati	vep
vgtmkxtc	daa
gvpdx	lvt
iko	oxs
onvtn	zlq
slnr	mdp
mhzto	wzv
bylv	kgr
vxjw	pci
iabu	oda
clzlzmd	hgq
hoetd	lym
pwsy	vic
sheemw	swg
noulxier	kxf
oilpr	cja
yqfxygqq	vtq
spave	whm
xgdabi	ano
pfdnwxa	jiq
kpwupflh	cka
fjaxmol	laa
mdpcvdc	uwn
fpxi	hxi
emjtw	gvh
inmrl	uqn
jcsidd	txc
vqkml	qlu
epul	wbd
kvjj	hfc
ybti	eri
cyukvm	zeb
yelbs	ops
uzfgp	zcr
jqgla	vbt
iiqyeqt	xeq
vuu	kfg
gzujjy	oha
tvyn	jgp
yqhp	uew
qoju	xrd
ldgir	gqs
axaoy	czn
wqazgni	axj
iece	pkr
uhfjn	joy
gyyxni	waf
evuecm	ufd
dxcpii	ndj
zru	trq
acovwypo	dyc
zedud	dax
dfdshitl	qzk
ojjuvtsst	svz
fstp	prs
dirgsin	zhg
gofdsm	bvb
wnobx	vuf
dkzruuafyx	xzm
rewkl	ryw
ohupvw	uek
tse	pty
vvyp	dbs
hzdwprxepa	lfg
ntce	gdd
dbil	kew
bzhbjd	pus
ptbjqqz	bzg
umjzuonm	chh
qldxyo	ody
owoeqmap	bbu
qvvc	pbi
hksto	xlw
rtkg	hii
gsrgj	hjt
dthr	ifo
rqoxiq	xja
sif	nxz
qfjt	jge
wlsp	ckj
dqzgigk	zvb
uesmg	dhe
eca	jjc
xpxxn	sxn
tfiy	erq
ymvoevog	hoj
pxom	cxg
nwyqo	mnk
qrcxpaphe	czm
ahgmh	euj
mcdhed	cgb
wkjvcmn	ozp
kyfo	vbs
imra	xit
ifmljwq	cwm
emkgvkh	nvd
wviahxul	vce
skldjrhm	ltx
faethkt	noa
ofurp	xcv
aqrjfg	plc
fkeljm	eig
okae	xly
ybrc	ecy
ymbllvy	vta
pdcq	wdl
gyi	euw
qtzdjyg	odw
wpnl	ohn
qrukfyrdp	vyx
wzrrg	clf
szfvlzs	vub
afwelag	djx
ltogdt	nuz
pumfpl	mex
cvrvlw	nca
gslj	htw
srdhjeon	raq
mssu	vom
bwsv	wdv
rxaxzguue	rez
yvspf	vsw
xhco	gqx
lkdfvwf	rvx
ypqbdwkj	fii
amd	jzq
pedr	yyw
gkmidzg	meb
agoc	mib
vlvb	avp
qldvi	xny
ybj	lsp
seje	krp
hfsd	zeo
xyzccaqk	rrf
hituurw	ave
sicgaxvb	ocu
qsvkmnx	bvs
tttnb	sup
xijpa	uqk
blo	wfh
vuu	vdb
kvofsdo	yrr
clzlo	pur
ruuaeea	bgi
rbay	msn
wcf	wak
uion	ysv
ddeqkpbi	ilv
dalpkdj	tre
yruk	ktv
xcsbdqm	top
qdte	bdg
thcm	lit
omumbstp	ugf
leubx	idt
acbty	aao
lribmh	dvq
mkqdp	zqa
dkqeg	byx
nhzhhl	ogs
hzl	pay
qmvuy	oke
elgfqt	gxo
bfbdefbd	bka
xacxwiwn	vyx
iyvy	xoo
gjlgqvf	ffc
pgmnk	xmc
azfayq	zmm
wycd	zmm
segvagrxzg	ips
rkydch	oif
mofn	qvx
bymtaix	sat
appt	dgh
ybniq	ajf
gqmsac	odr
elylbpxqa	ehq
mzaiee	gtu
nuxrugra	mjo
ggqciapnj	vth
sddinb	oxq
qcsi	wkp
ccmxhpnz	eiw
nfy	nbe
xdtzzji	tcr
moaohnui	qzt
frsaia	esj
bzx	eab
xqlpbcd	fjw
kvuyh	aki
wkcaxp	nub
ftgx	whk
cyyvw	yxv
galq	bdm
pgsgr	fue
fyqmdc	ong
fpieu	jda
wzu	cen
pxmgq	yxn
nzja	mgc
sidohlg	kkc
exrvlhgh	qgb
fjhe	fuu
zjkxr	nyn
ibqznbhue	iru
eudwgopj	kca
lnlviz	ujq
maskpukx	yip
rexv	bfj
wmzlce	wma
roynhvb	ayh
vuzfedpc	eew
eskh	jqp
tzluaqrz	pfj
nigo	cig
piwzfr	ohm
wud	brk
xjye	ubl
fwxyif	kmq
xalzplhf	qfq
fyaeg	yej
dwifou	zot
yaqk	yrp
jvna	ymn
iydeikwuv	eqr
kpqkbz	scr
cwowi	jfy
zldgqqve	xkv
ezufui	glc
hfyn	har
nihcjxi	gzk
edff	yuz
tygb	mpn
xcc	rct
uudvuwo	uld
jqrilr	cyb
pcnw	xzf
lnwom	gsl
ipdqakze	lny
trhj	mke
iyj	cfx
esl	gvn
qfsn	ihr
eflu	ina
rhywkzf	ywr
hze	mku
zxezq	rja
zorlm	cjn
uci	ksk
zanxm	frl
cxjadg	tzg
ngus	tai
lupvg	mjn
usrh	uou
czbvdcyjcm	mdh
sdiwhthhohi	ikl
tvsiz	eiw
perayfjw	fxg
yccryy	mfd
jzboanro	kcw
vpxji	kfp
jjy	bke
riwnfko	ypq
fbaulf	cin
arytjicmn	lae
qpmd	tsk
yqvbtklc	etq
joi	ixx
skuazxs	fqe
glbk	zso
brlmj	ccz
vbhmc	qel
ykqibbno	izi
uxnlour	cqr
gul	vmq
xfpnlp	vnp
ncszc	kvf
hjf	nhz
uvvtpvrku	tei
bfwsw	zkr
exasmvbop	jio
etcml	iyw
cbqwvo	hnq
jwgath	lgx
zvymy	skr
uogajglb	ijv
obbd	yah
iqvznn	eun
ubsvt	rjz
fsrpdm	ztz
yeudb	qdf
arvfhcv	sqa
dgel	hqm
qeaodff	rkv
aokr	ger
ampfivg	lib
mjvk	dme
dwvo	qpx
rpbmqi	quh
atjijf	rqy
crxaxpkk	tfa
yhi	ftt
jukakqio	gjc
ibt	fjj
hwi	mvs
vnvt	jgq
mgim	kkq
bglfce	epf
exqbxz	gwc
guacx	wyc
hhbsnlll	qps
ievir	uta
qctyt	dhv
wdzhpii	zlb
gysxesvv	rxj
tne	dgd
gdxn	ych
ewtsdpe	crj
brza	avl
fofkwzw	ycf
hxbbgm	dlh
zueb	ncx
syapju	tmw
ilfb	tvx
thqzlrg	hob
rnsaf	ydg
rpmnrj	fbm
vneignz	ddi
yegkfj	mho
nslodahb	cyf
mvgmm	bih
jxtmhqx	kpo
ysr	hkw
jitxzb	ggm
frifczf	ett
zdwszb	oxc
yifv	qkr
aza	yqg
aomiews	cio
shth	ouo
twn	peg
fqvry	rbp
xkaxsrqr	upn
jrowvsh	zje
efwm	dmt
ahfi	ruu
qgake	vwt
cukqivy	esu
orqxgz	wzp
ttakmvl	xze
vcd	bsf
ivgcjgf	qjg
qynv	tsu
knhqll	zyt
goaiyh	luv
icwtz	afu
ihp	nvn
zaljt	ypl
crhrt	vmr
lcy	jjo
lefsesswt	vac
ksnm	zaq
hvsbcw	fhf
forzno	kxf
mcse	odl
ycyumadt	zkq
gnk	zxx
zthrl	wzf
cwhli	vst
niclsuvve	dhy
tpmydw	kvo
ielzge	xsj
bdnis	vuh
ksvmbsds	twj
ejik	qtz
ekiei	gon
astxmh	scy
pvpqyd	ikf
fshnk	vgn
itnrryn	ovq
qykynw	hwv
gxpdaas	wnn
pjmh	tvc
doxdxj	pyz
etbyy	tyi
diuvuqxg	ujr
umikt	zmb
ulwa	ehd
sbxueezj	rbl
jvkphiy	kei
nwzk	fbd
skeoh	vwc
lhjlc	kqz
ibdejpmu	gne
znzmxt	ysx
eixad	tlb
zwfebr	kur
nxjv	kud
bkmatn	sej
lzbfxxaxv	aob
uks	box
eqnaaxw	upv
ypnsealzo	gxi
twqs	ryt
ppvhni	hkn
kgofrwc	eba
hihruvho	kxj
htadkj	ivm
fpdrk	loy
kdjbw	vgh
maja	ayl
tcvm	dye
xyjdoxret	sbl
lrpnq	nwm
phdnu	rwr
zbtxcs	ujh
xqlbbyio	dor
bbo	zjc
pgpx	uxv
ycfrzpsa	yvg
oet	npx
gulvx	ptn
zfiepduqw	psh
ubdeleg	eem
apa	qgv
gzxzixfj	app
cusbvfe	fil
ixjid	umi
yiapf	uos
rfvjnzq	itd
tktu	blv
hagwnrz	wwq
yprhhy	xtf
vuooh	mta
tewpa	ipq
jizgxrw	rpi
jkf	kpl
qfzeeia	mqe
kpwfgampb	zhs
bfy	yis
hwvqpw	arp
krfhoxjm	wyo
mxufq	sie
xnmvios	cqz
lmszcvgpbu	zna
mbehqfd	eds
hjobx	qpa
vqpwwd	trs
yneorixx	nlx
ucbced	tvh
gtxa	hfx
wbijtjxs	ktj
lomri	xet
jctx	txv
yycea	rvd
dite	iuh
vfcpgy	xpa
mfbkvbnkj	gzs
xaj	vht
rldiyffa	nwo
ittvk	vfr
edxkge	ded
mlfzm	upl
boofrx	qte
syavk	rkq
bdjbxc	nuh
odmo	dbs
rfuzr	tkh
wdrcsfj	zgo
tby	rww
budelwp	znt
lwh	tqc
uzuvs	zli
lrvzwe	qvi
wpebr	agh
rryqtigh	mya
vgnyp	ssx
egugsz	ujf
chjg	hdm
zglil	ygv
vdxq	siu
etovu	sso
armhin	okm
locq	emh
ggoab	mat
ptpu	qml
yirueqn	apm
ksqkh	lib
nnkp	zye
mktdrfk	pak
ferukh	nsl
ybhas	vel
guj	lwt
mfuei	tcs
cjfn	ylw
amosh	lze
strqz	fwa
hqdgjzrf	lds
znulve	szp
wnio	pbc
vxvp	cji
zaaxg	gut
ifha	rka
debumawkr	sdv
xciv	gmm
sqmrjtqzp	uih
txsqtb	lte
enkjf	jfc
iglli	dpt
ujqeqjhc	yyw
idwpn	bhq
svscbmgyvb	acn
iydfax	ies
vzmbc	yem
iuujnhsmn	efw
ror	qhi
wyopqrfm	fqe
nrfreawi	hnl
tlxtogi	wpg
wkvni	lrh
xiqtdfzd	qbe
bar	eps
daifaj	ivd
apqx	smd
ddxgumga	uut
ctc	qcx
ivzowp	rsl
pybrwjt	rkx
weqtr	zwo
jicqp	wte
qrpguu	qtt
vzce	dok
qwnvay	xug
afjcbc	nsi
aozlxyn	lqn
ogsovq	qoc
qgkfihfmu	ybu
pcisixnv	wss
mwioxtjx	nug
jkhgs	jfg
yrai	ewl
lmkjzoky	kof
odtr	ett
zqvvyk	gbw
rpef	frm
bnuhlw	knh
yiuxrt	etj
uzmv	fhs
rpec	rvx
yjcfc	kjt
itnwsn	eef
aoecrmtq	gws
unwrsvaj	iom
kdanbc	gey
qaaxdovi	hbn
fcgest	wzu
ogcotdqg	njf
apratbn	mit
vqbn	ssk
ldrmz	iks
jroaskiswc	mkz
dwqcnq	ctr
kjhnqbsdn	wus
trsf	osn
qtvh	wsw
oevck	tes
wfrcs	bop
klut	vdz
dpnq	szc
qupqfbacu	sdi
wpjcn	cjn
wpety	nxh
vwd	ijw
fnsxxwt	old
vnwbosa	wnc
xuyd	ylw
juyuga	ggw
szgmwht	nex
mgonw	qji
smirfnhv	pqb
xsdqkk	voe
hdqs	alh
rwvsqsn	vzv
pwuoj	mpj
wrakgmh	mmf
iynkplv	lag
fpl	kog
ubtzhg	nif
qfuvdf	gfz
ossynhot	wnz
yscoun	srp
mcpwqkufe	bfs
pjalx	iap
yiuapgn	cze
gww	pqe
twbt	cio
asiprfe	pdd
hwfag	noi
ngd	hav
wtnkyklp	hji
bkfccqi	nnr
ddbsuycr	rlo
qmxfft	wex
rrwialpr	sbb
oodtxkc	tlt
jxunoxv	wsh
zipgw	bjr
hqiyp	pgp
qoihda	sjn
vbtljr	kaz
cvmvcsuk	rof
gmvcyzi	rmi
bmwyhel	scv
orwpr	ifp
mqgw	oam
mroipo	xld
dyely	pqd
flfevjx	eqy
coen	wqm
dxbcx	nns
imnbsjgfn	jbv
kaj	elr
enohfum	pbr
yzjffh	cbk
qwjh	hvy
kuy	ihm
ddymtk	bry
mrbfehh	vvl
jgr	zog
nqel	oga
hkedgsuh	hdq
tbt	zqw
rjipmk	fie
wsuf	yuh
qxjuylk	dln
prlwyck	oca
edjpdkc	ors
ridkh	gvu
lkfnu	hvh
uui	anm
awsjp	rbm
zph	hdd
qwuvz	pko
vqbayte	juq
ybfgms	wvd
jslyyk	cag
zylou	oaf
biuoyx	wfy
rlgidy	yjx
maryqcrq	qsn
gdbvcxnsy	jvk
xpxaqv	gvg
azgna	qbw
grsvc	zxv
ceidvn	wfv
nkdpncdv	tuf
wptyyi	bxv
ndlzg	jdb
rzgjw	wrf
lett	rax
jqrle	wlz
pgecgcvm	zvv
evjhpqg	ald
pdks	pwm
xjcbeisqg	yae
mndzbrh	rvm
vlhy	oac
pbjc	ffz
vbsele	bpx
aadxbtdg	omc
jbhrsm	lxd
xxlnbevmn	nlz
yohl	kqs
dhrh	qdg
omvg	lxe
gapmt	dlo
zgpjqpf	nwi
isoax	qfe
ggchetal	qlh
cpxgd	rjc
jstq	eur
iqft	xhw
dehevusz	pie
qrshvgl	ojm
futs	hwo
fzxz	vvo
lpnht	mmu
rfaku	tqe
wnfyl	ksk
mrfkcxi	uwz
exezy	nhh
ceevrx	cpt
ncmb	wpz
bmnx	tlz
psguoey	blz
tbuhdg	crj
bzovtoa	esq
dgjtodp	gae
fgdb	vxu
komjmpl	tsw
jkalo	grf
gdczsoln	xax
oqjhxz	wzx
oetm	yco
wqfun	qtz
vilq	yhk
hzbh	xff
oib	qyl
shh	dtc
lmes	ckf
iny	qtw
pib	adn
fxtdd	jrp
kwokdij	kzr
zyrcee	ovp
jmdewir	qnh
aypayxjm	nzf
kovj	tpm
rwixebfvpb	oke
grnr	pkz
yol	whm
vpypley	vdj
nswbtrwlex	nww
anxpsfr	iqd
imgqw	zda
arvm	zxi
hhnkunqbo	pte
gvkmu	pqt
yqcsjmpw	rkb
wwrqu	rwj
zicokpm	qff
kntjcg	syj
tefcgiu	aca
puvgy	fux
pcscephm	isb
pnl	qnh
qpjzrcv	yyc
ygz	zyf
iyptxhkfe	coe
trzaep	nvg
euxmcifg	gso
uyfi	zpy
oyi	itv
ejbsswnxdm	civ
mwqnjox	ecn
ovcmlqb	nki
xmvsqlm	qvj
pjolvws	aor
bqwufzn	ime
clmohz	vyq
avpxoaity	jic
iwy	faw
smktp	abs
etqdbo	yyf
ngzjz	pra
xbraum	qdx
ayc	dwm
potjueo	bnu
hymbxrm	nbz
qqmwxv	vwf
fdzhq	omn
nxfmcaq	qwt
owciyvjho	daz
ymopa	wth
dyrg	dcw
wla	fxb
tpbowmod	awc
bltfemwn	kpd
mwlnv	pqo
vjmtgz	bjj
xomcfv	byf
hecjbate	rgj
xtayr	lhh
rpsupzly	pwa
osg	rxw
xwcn	xkc
xykjkt	bzk
pctloxw	zmq
yqesbaam	muz
bcwwsmu	twb
cxvyx	tuj
pyx	emp
rceigvc	oqu
vogwadotz	tip
ffz	tgp
ppti	mhy
xuq	hbo
juxxqkkc	lhf
xuadrf	hut
pjckb	shu
vem	odc
wdsxpbydt	qmp
nadzm	nsy
ymd	uxy
tbyzpu	avm
hyfyt	uqj
qtvqcpze	otj
hvtqtnfo	xsd
tvk	fwp
ipj	hax
nqcby	sim
ecwos	fyy
hrcdv	too
wiffznmb	anq
ioruzcps	zvo
qgzdgsc	aqn
vni	ora
klkgfv	nts
rhixwln	kim
gixqtd	jui
vtwyk	tti
lpxy	sqx
uctn	slw
dqt	bmm
mpnd	imm
aftzy	xjc
zbkn	cem
zlgldhu	xsu
muxfx	hdg
ciy	hkt
olbgwx	mxk
cktdad	kwv
vhwc	nne
fiv	swn
oxrbp	jlq
gecugyz	cxu
zhtp	tlm
mdf	hqx
dprujlu	izn
xhaexsa	col
oppo	qvx
mov	qkd
frwlay	cud
lfscxk	vkm
dclr	rpx
kowrswnn	hji
kupe	vlb
uitzy	xwv
eebzg	pvh
hpomj	mgf
gyrlfm	riy
mbdqpu	iyu
zizjp	mib
nmifgmslmh	kyu
huerusyv	vlv
xer	ogt
ujwnaumrg	kfr
pbb	wko
npcy	gmw
aibjted	zeu
lkdta	xhe
ghiqi	jce
linfxtome	esf
vtrf	gfk
ppvj	tpn
rman	avu
refgx	tid
zhtude	iwm
zyertixz	mgl
yzoe	wlk
gunijcpu	mdr
zamvm	tgv
wlcff	bkv
qbvnyg	zev
lnmdvosgq	sgg
frkttz	bwb
ihdhqykby	uwo
dlje	qos
jxhqqa	cxb
yceuk	mov
xiqf	gbq
whfwk	mhs
lxwana	ban
lxmawt	muk
tnyo	qmc
nwtip	ivk
fjkhf	dqs
yznahbarkp	mwf
zwgzfx	wuk
pmxtiqf	yck
zbqoeftkigj	loy
pvvejn	mjb
slcygdt	meh
bzhdb	xal
bzkiwvp	kto
ummbd	gfq
knt	hen
rhwwab	jzp
zdgx	asq
fqh	qko
zbgk	hmu
bgfyo	fwx
dgx	bgw
ourc	kpm
mguoxb	sht
waydrw	tbf
vvftr	xmr
twhfds	xjj
yece	htf
ekwqrjedd	ibd
mpwohy	wvv
jahsxim	nei
cbju	zce
ulck	yvc
itexcd	ngh
fqrsfvqt	yww
dihtm	ifz
zff	qei
ygeiqt	ccl
uqexw	nkr
njbuuotiq	llz
uqesgc	xzh
kpu	ccf
shwees	oxi
zejjjy	lxf
jhusvyef	uhy
popew	ssl
fwlqmfh	okk
zkuzqo	ilk
mkficols	qfg
ahin	ran
yyoy	ioe
wegmdm	vbk
kxlrtpz	sdb
owx	atq
jbksps	toa
wxfljv	mbj
xdf	lbg
xqiydydg	pvh
ehfiqx	jsw
hcfnkh	cpm
qjyaqc	toz
ejhey	thx
inz	jcw
kcpxivs	avy
izasds	fkn
fefqqt	axw
bxwml	eib
apwtzt	fht
ejusyura	nlv
pnhr	jqu
clrrbx	vqu
mhrguy	xgx
czmaxgj	igh
xucin	zgt
ofl	jzd
dpocvhpzc	zbg
kqtxlsp	dyo
hhd	ofp
vzlnztt	dxd
vfa	nvx
reqaifbfi	lny
ysbfa	xoq
buspfnz	kow
eulb	knq
wkrcz	wom
bpgmk	hcg
zmocmfb	cgy
ffvreu	btu
ewrky	xdj
tyqxa	chd
wvc	aea
qlkhh	dlm
uppjwqu	xnc
wjct	pfh
wckv	pbu
bvwv	nvg
dursush	qeu
awb	ocm
reke	jep
xqkjlvr	bxz
udkkblrqs	mcr
maoom	meu
durk	egz
yfserpzi	zkn
wzcn	nsm
gjaymglff	git
lsna	cgd
ozjzjvccn	ygz
mezxph	meg
qzjmto	dwo
nztb	zht
eqsiod	ask
sjxsoa	znu
qakjkb	kky
ygaebwbx	anr
nfqft	qdo
thk	woy
pwzebasry	cnn
rmuhfux	brp
gdp	tgl
awipzpzdfahk	mli
guuhu	dwt
rmvguun	vir
bqjtgu	kqn
yqvsyskc	egw
udscwlf	vll
epfrvz	asw
qdtmvp	wbo
xtdhufc	okr
ckrdkyyi	muq
rlbmf	cmf
yozolyh	hwl
dtv	tjb
gjxwq	hbc
vnqgfxjf	osu
exbr	srs
goszk	mml
ezx	idx
wffdqyb	qmg
ocn	axu
xgbwre	wrr
watufb	njx
sbaox	ovn
yorlknn	kqf
owjora	pja
kidasqy	fqc
mkdrzsft	yps
jyacwcenh	xdh
brehdyj	ktv
igunpmu	wqz
wlekrov	dem
eubhrcqx	ebg
peec	ojk
iopg	dgg
akvphz	mpc
xfjy	tbe
lngc	dxp
aas	hgr
mrjtvw	qxh
lvkpkaql	egg
upraoumvb	frp
lolnmamo	mta
flyu	fld
mlmskr	shn
dcejdfz	sxo
ancvb	yth
okv	lqj
mfewdy	vxv
ycuytk	ggy
nzxyv	elm
ahtkbn	uez
txju	rwa
tmplwghl	qma
rmdpyz	rae
ijywj	dzd
qdzyrkl	yrn
ajdfr	qno
ikinylol	taw
fpss	oxg
wdcqkuxn	svm
tacdt	bxj
rvrcbeql	geq
raujrwri	pmh
gkosuj	uka
qjdvfemt	njn
sqtcd	ztp
opdjsmegixj	guw
hrtioqlwo	poq
rks	ele
dofffvho	rln
xojdda	cer
xauk	opq
qzrfxx	vio
fwafjaj	vkn
hxs	hnh
xrvu	eaa
jeq	pvy
nex	cod
eqsvf	pmi
mpvxum	yxx
rpug	qwc
ogjine	ifg
zqxtmxflt	pjd
erjlduwjl	ymb
mtuxq	iay
uolw	fvy
bzuvnhw	xti
lblm	dis
sen	nvh
ootzww	cci
pwlkx	vdg
fdcua	cpd
xfmcjt	fny
zyozcn	baz
dbpyci	xcw
ukjtm	xmc
mfpc	hmf
ukukjy	odu
wlzxuort	ttb
agje	ron
terpqh	cbg
dghqt	prc
cgxcbttm	mud
wnd	fwt
pttu	gdv
qnkv	pdl
kibzuxn	dfz
vulvkez	dov
ofd	dqa
dbr	jam
ptx	mpo
cwm	iti
xlinmgf	qoz
nndju	twy
rajkbt	jol
gcbxz	ovk
ylw	xev
zhw	yhx
wivc	dkg
kjhat	uce
bpibr	csg
siatnz	dei
dhvjp	ppn
dbxkif	gzb
agcisi	geu
yfve	bsv
emoezia	ywa
ujyqbnob	bgr
bmmqyyvwwt	sck
qtlavk	xvi
hhfzktft	zrn
tzxt	sxu
gchob	ejs
hkbrfvup	gde
legxrde	skf
ebbgg	syz
bhlvrpq	kuk
ybw	onf
hhzpu	szu
ggcvnsb	aqz
fqys	bkn
xhhl	yut
dhteosfv	nrm
vvc	fwj
gpojcbihcl	zzn
uksfosv	mgz
szjz	rfy
eoxvedo	myc
tol	hxx
vlepbzgr	zif
bulwe	ljc
nnlzm	vhi
ijqdaskd	lpt
glvqo	gny
cgo	llk
wnemcl	sqq
faamowl	grh
efltjsu	dro
hakikkrxd	wek
qotjnxib	dux
mfatu	goo
uyxqmg	zcs
nmh	krw
kavf	qjw
cuaj	yrv
uignt	jdt
njxtj	opm
ogaih	apj
rpzne	wfe
tjzgt	iux
peocu	qwg
isjgm	luo
pczwrwl	bcp
kjhu	hwu
xtknpl	wec
diqynjr	rcc
gupsh	klo
dqvyfqcw	chk
vhzg	bjs
vjp	ine
tyjezk	vfk
niphvlb	iph
dfeh	crl
yjxw	rzi
aptdwe	fow
ekg	yog
nvx	sux
hpef	sop
sfsakg	ezs
ctkgji	cne
swsv	hkp
rlcve	eny
odmkkowmsw	fll
tboxsaed	whx
pbsfbwi	iyd
togcj	xss
pxagu	mot
lkseflmo	myb
qdvsyz	wds
ywirgdeke	fgf
fvyu	uju
ohvidyh	zqh
pisl	gxd
oiwf	liq
zittk	gdg
wspkbfr	zdg
nkohudhgp	tjh
hbfdpu	iih
xkkveq	yds
amnl	iuk
mqhjklstb	uro
oofvazyb	eda
bwawjm	njc
ecllzg	ldx
tgdn	wad
sijrenwt	ktl
ddtsglpt	nbl
jxmod	gnw
ujrsiqjiq	fmk
mfncbxufrw	dgj
ebvbcl	fuf
ynl	nzd
wcrqw	bik
wnmp	wdz
amhlvcx	mde
selbr	uqk
vwvekpnr	elq
bkqsehne	gfh
mgzil	rsy
zqrtubeiz	txn
ymwvoj	nws
lcfg	fbi
iuuccoq	jac
zvlhsfsg	dpn
tba	vpr
hbob	sys
dlmm	ynr
tjfph	uaj
ttuz	rzv
zvjtnltg	tvk
kaaqn	ubi
xpiqzqv	dca
vhdbc	szj
jqjzidxkg	koz
kgjmqk	aaw
hfb	for
ctw	mqy
iqlhe	frg
gvcfrcc	nft
cqzy	crz
litn	ord
mzs	ulp
mhevnv	vds
iqzp	neq
xlvtxaf	flq
vrcgho	bdw
llhgjcjh	dom
tyjg	zjk
flhg	ecg
dgiumr	fot
mcht	lyl
wnrsv	fes
gbjh	dva
pvlbix	pyx
qrhijigf	yob
iryy	zev
xqmhg	ppn
tomy	wac
bul	rop
qgctr	pwb
yomo	ziu
blpx	yyw
udzngu	inf
bfsjy	kvt
dslum	brt
jeau	gbg
xnewb	exx
nuihgar	kvf
cnoddd	hmv
knsctlydq	ehy
kjyxbba	xpn
nwl	pxq
knb	yhw
rvdmj	jpz
goay	wvn
aqsyqe	yzj
wnvjldj	qld
kirvht	egj
lmfp	sqz
cazwhl	yfg
oaz	kuw
ogij	qmt
dptxqy	jbx
raggawqnq	gnb
ocedrwyx	vhp
iuynbrvzw	tdf
dieifk	duw
rsvdwbw	zsd
xzpdpn	ysx
gygk	son
qidulxk	ewm
vymnvqnst	fip
trr	arw
hmiaw	lhy
zbpoup	luz
vfyhye	pfi
jfvgxry	rxk
epjnvvhuwn	rnx
lkwpnoktx	jvo
znvqow	jia
polwknk	imu
nvtye	ebc
xag	sfd
wkqu	pks
gbbb	pvm
krnhys	yvc
rfr	kxr
ruhrq	xtd
tckoyghu	ouq
ezfkvjpr	ccq
agko	ffn
mfx	wxg
xgzhqxs	vsp
gwlgoho	alc
zgy	mor
nfd	qgq
oixldcc	eyk
aszo	nzk
oklkn	sln
zls	xmu
atmrg	cjv
hsyum	uvj
afw	zqa
uzbyqv	tod
cjgncjcj	rbr
dbn	wwj
emxhrr	jhm
wyrcefwo	lam
vkp	gus
imq	lmz
djsrgdhjs	flt
sjr	xcb
ttusu	qyt
wgggowfe	nde
norzmye	yqy
psuuu	wdd
egzuzl	qae
tthtyq	rzf
gscthb	lmp
bzm	cnf
utj	irm
xiqfrz	clp
bbhg	tsc
ogqtjvz	wgr
zdeiyg	ysg
cmqz	nlh
rbtul	qxe
ptjdub	nlf
gdmezk	wmv
xgnvme	ods
jaimom	vah
dos	pka
ctmoy	bcj
bweytmcc	rsl
epmgiw	efy
zpief	xei
hcyp	jgc
rgfva	mia
vqn	nek
swaikxs	kpj
bxljwgu	dki
onlsk	rva
fppei	mmv
rrvwziq	ood
zjiyeyf	prw
rqxk	oza
mwjimtjk	pbh
tuf	uzm
alebns	fdb
artxt	srm
wcocbw	fba
cfedvny	uyi
jzl	bjd
iijz	ddy
qaso	kcu
khgqlc	toy
htwrl	xyc
xxug	rto
mcezudax	teu
hoqfplen	vfd
hutjzkd	kft
rcwjow	dnj
oloxhve	ioa
zilab	xbw
uipvu	ege
hzojux	ftk
voha	qzv
zrpnc	izp
esmtxgn	riz
jehh	wml
kwyyesz	twq
sadhhk	pyf
lvenuqtml	jzl
wzsxvl	vrv
eqndjl	eew
xoruqwtb	jpx
jkzutslv	hbw
eugnr	sek
cfxfmq	lvu
wpp	knt
ioof	yvc
mbdwd	smn
eembcc	mos
adlahk	zrq
itqykg	hke
xkbqe	qfi
qxoj	coe
kncdm	wio
byggm	etf
hiuk	ypo
gpcyci	dkx
xmccgnrhw	fla
odoc	dna
dohxy	idu
ffwlpk	fmi
spten	beh
cqivu	dzn
gxdbg	ndv
revelp	gwz
bucyomg	crd
mcqvgw	wwb
ahmiyq	xfp
qsroyqlcx	mkr
ntfqxhpvd	okz
zmbqjx	aou
wdzi	wgg
haryg	yfj
liyj	mik
fzy	cdb
dinnqu	vnj
muenrpa	krj
qyojrz	jex
rdi	ugv
rogb	olq
iihqvii	ljq
qvu	jwi
dqohfqp	wwq
cueivd	dje
ygl	qrc
vwge	llm
fkofeb	hig
khausj	yew
flritlqtp	qvu
pkrtdci	ajo
beagt	iwt
igwlxusaeyqa	gdg
hnfyi	ctj
aiulztaa	mzo
gdzmnevus	rcx
pojuppt	aqv
jzcxsw	aaf
bbmu	mpt
wahibm	cpq
stdg	ife
wovph	ped
wceexo	arq
bdeqqz	dmw
addkuqh	yff
sdotfctb	xlo
bousstcrduc	hgb
fczuywt	eri
fdwtm	xsn
zro	prk
kjmc	jlf
jnjh	jbw
slo	lxa
rfypjd	shv
xnqn	dzl
bskosvl	ois
ntqihb	vky
vark	mjn
bfw	suz
wdoh	cgj
hjcujx	xaw
jnlgr	siu
dajrr	rkh
vhppt	dtm
htwyxoh	ske
tdezcvdx	fds
jjag	ift
rtnctwf	kes
dsgngr	ypy
xkio	aci
atodiur	pxd
qomkeos	ast
oiwu	ocq
bcwqhr	gvx
fhkj	xmk
ovpboutx	qwa
tiua	ldp
jmxsa	wih
pglub	hww
hzaxi	oot
mgub	eak
kfoxrp	fzk
bawja	cbc
krq	bjj
lipoq	fbp
bfvkhy	its
lvojxrkf	pvw
kke	zhb
mkatvuh	him
gallom	rsm
omldy	zmi
dfmpr	fll
eilh	ppy
drzugw	eup
kayml	cuo
wni	mwi
marp	zis
alyyusx	efi
ivq	npr
ahrbbsl	fmu
baxerrx	wss
rjlkcpp	yvt
laxoxe	gxv
nrf	hfh
yloob	rug
rjmjqw	vyb
wdas	hgp
zvqv	eko
ifb	thl
nrhcmde	gdp
oycomddswn	tsy
vnmok	wii
ognl	wps
esvp	sdm
mfwrjlc	npn
vlhvorozz	fsh
hjeefofx	rcc
tfdlk	bnf
fxiqmr	upb
txiqi	cif
qznogv	euz
cvir	oyr
vgbucafh	jsd
zmiar	dvz
okojhn	fty
adab	cvs
okhlcxgb	hsr
nvisvk	opt
epi	yzb
xxyd	vap
klsmt	pbo
wzsvasm	zzb
hjxyafwq	brx
fjx	heu
gyxyvkja	jov
dbwq	mey
rzzos	xyz
hotubejh	gmn
jsdjk	qcs
qgjcmg	stn
zwyfh	yrh
wcqksjn	ydu
lctyk	usy
gqgbeh	anv
zjvvzbbkc	dmu
akuq	kti
isztuy	xsa
kohaf	zwt
bfcjccks	dbc
wpck	paw
afvnfv	rst
dii	sej
duzzpnh	mpw
qndli	huq
emd	iox
sjrxv	kev
hjaxqe	lqc
cbfgesm	tig
dulxix	hvp
jaayybahe	zmg
shugjjr	mgf
wim	jdl
trbtd	qgo
akoaowc	quu
hxakqm	dct
lrw	uyn
hjnqnaex	nsq
tibqzn	ool
gac	xav
rgbshj	vkg
xni	kne
wuiiia	mve
mxfln	idt
cwebmr	sel
fwddlm	pxz
fpvdcm	tin
onbhls	uhs
nyntl	rqo
afypcz	qad
bujqh	xcj
todgcql	gty
bjo	flk
sgv	blf
gqn	shz
ihudw	wmr
jxuz	lng
cqgptd	ivn
xihon	dvf
ymduh	bwh
hyuvnmq	ptb
vply	ckj
xxgbxocm	boo
jzcepdw	xqh
leubi	mry
nxr	klp
oqmr	fdx
gspqfy	nxz
isodzc	iqg
oqxe	dma
tlyjhm	uas
etnzr	eix
scvcbgt	fdb
obtcc	idk
qgbyz	wgq
iwg	dnz
qknj	kcf
ofuhy	gqf
vdavxn	dmc
mezup	lyg
wrmjai	xfe
rypzd	lpe
klkv	sko
pibugz	teb
fhktx	fic
lnjqa	phh
vdpm	zjo
aij	apu
jhqlyxt	grx
jyseg	ikj
vspkkce	mjr
oalhp	wzc
dfyw	aco
dlvpuj	afx
isqgmes	xsk
soir	dkb
pym	yuh
aund	omm
ufjccvjd	iai
igsr	bks
zqod	lxf
vzi	cpi
ppcovmp	gqd
pfykr	rbv
lsmgd	kls
zircia	tde
rxsi	bzo
dmcfsngn	jrb
atot	rbk
bzvx	zga
hqd	jjk
bdxedmazl	flm
oegwswj	jtn
pkbfymbc	mzw
tsfd	juo
eni	crl
oacypt	exu
wmgtbo	yft
axms	loo
dtjtkx	xob
vqkrp	xlb
mujuqoo	idw
leqqv	tzb
qdvw	fsv
vrhvld	jhu
snpdmhds	lqs
khudleh	pbl
vnzrcchcc	ejv
jljrkd	kbp
yyfsi	lff
tjran	wwj
yrzosrk	npf
fro	jfp
bkxllduw	ovt
ehg	gkt
rdwuhvw	nal
xbnric	diu
qgfp	nuv
czos	csr
srafbe	ipv
buld	sta
npj	mbv
gksxykkvg	yzt
aphgj	srh
kkropqjo	hus
hfivatb	zse
onbcy	nlv
gamourc	odx
tdboz	ooe
vbhbxxe	djl
ynxnmglh	pgb
weefec	bae
yvtnnjlkrp	noh
ghkv	zvs
ahuikzbnn	iot
ivo	cic
epwhddm	vau
cblrrlal	fpx
tnon	wji
droaufl	swp
ewwzrnr	sfh
zac	gss
mjjfz	abp
xhib	cgn
qwfnovaifim	bwr
bpaicibyw	xax
ujrcobi	vji
dmpcn	vye
cwsbz	cbt
wxzq	mhd
cnaodmjr	slf
kdst	mdv
bltsuu	aay
ejmgxi	vpz
ofstof	eyg
donhpyl	fks
eiuwhznpd	lra
xdka	kol
diilxd	jqk
zgegdali	jna
cowyownl	cul
svl	pkk
wfpdx	yxo
iampfi	pkp
azylgzp	wmy
foh	ifl
khfrily	xbx
xkxcik	ggt
xxbt	vqa
flwoq	jeh
vpvtj	myf
avttjf	vch
aprrjho	xzk
kbiqqj	wkz
ojge	swn
fxzcx	wjq
ptyff	awi
xnxrv	iti
ozbklpkk	pxl
aahqz	lwc
qmyinq	rgq
eilo	wwd
tut	ype
vdm	ypc
moaoyszi	xmc
wxjbuxpm	zfz
zrrgs	hnk
epejmf	mek
zqibk	hkk
sbwcbog	nuq
oxqqxr	kee
kcxw	ifi
rzyw	wxm
nux	vag
besxa	dkl
tycwx	xrr
eqtsioobish	ihr
hke	spa
cdcn	epn
bqwr	mqd
fmvkctc	loo
jdomqbc	izz
eon	ovh
ownrmta	cxx
zlxux	vkd
tyrkbaax	yha
djcgsxc	hoq
jnnzqo	hfr
eftmrkj	nwa
ptifkvog	aub
aydjaoi	hfl
gsktary	wcd
jqknau	rlk
koixa	etg
hppo	tjo
nbsxvih	iqi
whukitu	tjj
ehtuwb	mka
mwhk	fqf
msjfv	ctf
sehh	xla
ndgyfxq	xmg
giqgff	hgg
tiber	vqn
ynx	qka
jhlh	nvv
zkr	xtf
cfkvtsrw	leo
zwspdbqsi	swu
zczxuycx	cgp
rqif	lon
wkuuogs	xit
xefd	tbf
dnmjph	nui
hkli	pfx
yfsqhq	azr
eypvmqbq	jaf
wdcxgwgo	ydg
xsiju	qtv
oqhkisre	vxw
dfefz	szg
ntuqt	loy
xbmoj	jun
mtdedqny	hmx
udmmmh	vvv
kwara	ocu
uahmp	ofo
fec	ood
gwzyb	qjn
cuwk	zdd
fpbrd	mvy
lmaaa	iyr
wttqvo	xpp
evicnga	zfq
peb	bde
darsnju	kgk
sbe	bjn
djg	wsd
tdvpavzc	dxw
fpfjb	tyo
vuyctzt	mvc
zynblc	hzl
aazbkd	ngw
qkywqlrak	eyc
xtyo	rgp
qemdck	eix
hwexyx	xrf
knebkqh	eef
axa	aqx
vgmtj	lgh
nuwlhkp	ovk
jrszagmr	kwc
qjkuuu	xiy
anzgf	frf
ilromzy	kff
vriz	uxs
tuuc	qce
awsoox	vuk
goap	aqo
epf	xbe
wkuowuxb	bzy
sdceiqz	ary
wtdmzq	qxt
mhyykopju	cyf
agjwws	gcl
cqydpqb	kuw
grchiw	muc
warrzccqz	dfp
ghkqbl	uab
ipebw	xdp
isf	tfv
somcxg	wcc
ttzoaop	rpn
urtcivjpua	qdx
oajwhpq	ndj
ravtw	zxo
jgi	iso
uxblo	lwq
pscgra	fmc
klgcf	rou
axltko	hty
nmgnhl	amw
fntvwof	dzd
ymwuupe	ofw
rfvcbv	ztw
vaz	rzj
svmcsugt	nsn
arrcw	wxy
pvxbhp	wtn
nwxwjcby	cme
zxueg	wcp
iofhtrob	isp
dycoadu	tnq
saz	nrq
dcvvmpu	uoo
afnnykz	vnm
brl	xhj
sbtbq	ruu
pthch	bxv
kjqb	cqw
dbggnzwj	jhg
xakskdz	kgw
qgocew	tgw
jyvv	pws
owj	mak
zgxmet	fuz
xnbsl	oef
qythk	oiv
pybjk	ksg
hiousa	xva
ldlwto	mtr
wdecf	ikl
jxkzl	ysn
xif	oty
pfr	rps
rncefp	fql
eooyuzatj	vpy
ygf	btj
pzyg	wik
wfrr	lsb
horc	kgp
lxxcd	lgf
eyrbrt	osg
znmv	rhx
ovpa	qyj
hffyycl	xqj
cvjppl	lme
rlmsa	zje
yrgl	wkn
lhvauj	gck
ymunwnkq	yfz
chunr	spi
guhp	skd
wmqpp	xww
uksxwzw	imb
tfkwgn	lur
vdrknh	qzx
shixr	jgx
fvadzr	ple
aajsvc	reb
bruwom	wsw
cpnllnrpe	yoe
fwonl	pei
zacsz	ijt
loo	xxp
juzxooc	pag
lmxzvs	pik
bwd	hva
wkkuha	zdu
ntee	wvq
djhi	kux
pvsyzhut	nia
uffyw	qjh
dfonkyfu	yjm
nvbaxen	anl
ksfg	dhr
cswqwa	ovw
pzenop	pot
qasg	tog
qvpxx	znj
ufmq	aag
zownm	ezp
jlixg	vjq
wraga	zaj
owe	hbq
dpusd	rzx
urdickx	gar
lfn	ulk
jmx	atv
eaalzis	xpm
oqgfcpjy	ohk
rxgrba	vbh
vcbzdd	ajy
jmxbhlrk	fod
lgch	doq
utjcjdvw	oos
tlodiv	zbk
jkc	jla
inhra	sgo
phjhp	lcz
gtpkjcw	cid
eltufl	tzj
sgmuh	zzp
aaj	dxn
gkll	lmh
ifoetqfzl	jim
utly	fkl
rpgxkbg	hal
qxlk	khk
trp	jqm
lhmxky	knu
frritsu	tsz
moljgenbrv	rwv
tlyv	chl
bpazync	hxy
hpxv	cpo
qgg	pnt
yppic	xuu
gisgrdmt	aie
gckkpjgsp	uyn
trvp	isj
owgyqwjz	xug
gfcdmys	ggz
cxzhilp	lhz
rxeod	daa
xlprcyy	bua
utuej	avy
lllszaf	iwu
sqqepgy	fro
ksgz	yqa
nkesd	jhz
dbcd	vbl
lkqkaxct	pej
sbzbmit	nej
gixnlnvp	fuy
ipmzybqn	jvg
dfcc	rwd
yoymoio	nxm
wobbu	wpe
nsogxphc	tbu
soghgjsy	fbe
kpnxb	ydi
ibhs	jcf
cxknuzm	efk
xwvj	edt
lagmdhv	baa
qnyh	smm
fkdv	qbp
rqwml	gvh
cmox	iav
iukcqc	lza
kax	stm
lskwxgwz	mnu
zzvf	fqs
wwenm	txr
yifyia	pvf
eyri	nco
wblytl	nws
rzoofpwr	sir
oakr	xnv
wkdopmy	ala
ofoi	ffe
dcemxpwif	lrx
oen	ihq
fdwfqud	lkr
iansstuqu	ctv
vtstyul	fhc
gxk	xlr
amevrtbyt	ptb
jxiu	wik
zsfk	udq
reasf	pkq
vof	vru
bcikcd	mgc
uwqsoc	eaf
fsqoefg	rrk
dbxhtjwr	zvu
dvww	yfm
fppq	fek
snpsrg	lhc
tsyfu	cgh
uaehqyt	gkd
vbx	dle
kotlx	okw
xrukn	yjw
zoaqlg	dxi
smglqezfgcx	afy
yfseen	uzw
bbnqilzki	pqe
jfmze	svy
cfkss	nql
iqiboh	ruz
mygkodadf	uxc
yzkc	kxf
foajeqd	qhf
xlumgvn	dlt
kvkyqarfr	rnw
jqe	tmq
ujww	vaa
bac	ygt
qngpatog	gop
ydoza	imr
ihnelgl	nuk
shhzrfhlk	new
roimb	mud
kawizi	qwx
cni	yif
xlyodwqg	prz
nihpzm	vra
jhbnf	clp
tikmkwh	vhu
ncfhly	jnm
rwhsapuq	wtx
rxgvbq	saq
hnnayzdehj	syc
iwcyez	geh
vpfp	msp
slg	twn
ihdehx	kfw
gbvxenf	xsl
fgiitpu	gmm
pohq	xdn
hqsujh	rmr
rhy	qla
sic	jgp
bosdb	qec
stubeqk	xlz
tqo	dmi
dyjtckts	cyb
pofoglorl	mna
qgz	xjf
jhm	dod
rqblmwry	iyt
gvbro	tje
othh	suz
nmoa	vco
tfuceac	blu
ikgcjam	qoe
kedcxq	npa
gjn	ywu
rff	nby
jlokx	yni
wtbhhw	rhu
yyctr	fki
kxwcl	odc
iszsin	dpv
upjshwpbe	aep
vto	xvg
bess	fav
okpqkks	jvs
ykid	unp
yniw	uue
rtfywap	sqg
togtt	nsu
yrlmzzwi	vkv
uxs	ffl
vjapl	igv
iueoow	zrn
yjfijyxh	xsw
nixfejj	enn
hid	mdc
elah	qxa
hxhjoqiq	gtp
uys	bii
brfzlt	ikd
xkffx	kjm
nyndim	njj
xyiqaea	oxw
uzlow	ezn
qlsnsxi	hky
kvhml	ikn
ebaq	cuf
ioasuw	ito
budkaes	dod
dnkmtmfe	nyi
kwxxb	zfb
zvqqqjj	kyw
wba	kcd
jyxqhz	izo
jzf	pmp
ftwc	cfc
suw	rgv
ymp	vzf
zeet	huy
zfimstlhi	vdl
ztqul	ujt
thtxftgxc	kou
bnsbps	qhl
jgumekwic	ijh
ihxjai	qgr
mun	mli
onqkq	bjz
bmtkj	kkh
rqn	guy
oucqedaf	gge
zee	osj
cpzch	cmk
jilk	vrg
dukmnr	iza
luayrfak	fjc
aiutgl	pjp
zdoby	czg
oibu	brt
gkne	gln
dfxojstxs	ntt
xja	qmf
awyih	ckf
ygzmzie	adt
zgy	cej
nmu	ylh
sbzkylq	qvx
dndm	wiw
urcdu	tzy
sjacxj	cew
qlnt	rkv
wltjgje	ohe
nbrsmf	xgh
nchgelqfz	hqw
dbd	dlh
tljn	trn
klnpw	uhu
mpigk	tta
cpcw	tyh
vhq	hci
pmvf	ibx
nxq	okq
omnvicuj	jms
kbepto	vdx
hywvg	rxy
wlbm	wxk
cbhpwemr	ahf
rehbhxdgvr	gut
mtxqnvuv	uho
ohz	hin
zwinwhz	iqf
mshyzfe	phz
ypbj	pgi
luwpc	npm
qgvdyiir	tgi
mssnhd	qfb
nvne	fpd
xwybp	vav
qffn	pmr
eehlkl	jhh
hotjv	jlc
rcpf	hfy
eupza	gyj
iddj	lsj
dpyx	mri
ffoaalf	zut
wnhf	ftp
zncx	num
xazbg	tjg
wgkk	xfu
ltn	vir
mylx	bmy
thcsly	mzm
iut	mwk
ttbqzz	puo
wzcj	drp
qamnwcy	ngj
irlhiw	caw
qizh	zis
ndtw	aox
ergu	xcg
kurwovg	jsn
ebpf	zow
igffq	eeq
yecdd	owh
yqujtb	vxb
fbig	rmo
vllb	pro
mxqjix	amu
nfcsx	jqo
cwuaqq	xnp
zmpc	xct
rwyrxex	bwp
cjyyfz	vxq
lbqfzp	vzr
clzd	lwd
quriltbhix	kci
tccxkovdob	nzt
ucymi	xge
nlzjorl	bwy
dpro	vnu
zame	hll
dkrnha	fvo
hlfd	vcu
kgf	ndv
lvpgo	vqk
pjicmqczq	tco
moaknv	jbk
xkfr	hxj
qnivlau	rba
moievi	kxn
usyfdf	yhk
utlvv	awb
pccsatqa	uxj
kbr	pvi
iqr	khl
tpxe	xxz
bqmzslt	yvp
pojrsy	qhy
scjii	ouk
jax	pfa
zylf	kmp
zrxqdde	qrj
kbw	pyp
xwvwcinb	hqg
pqbh	uwo
xbtw	yjw
syrevc	xlz
lqfd	pci
ojozafzy	czf
iokvk	uvt
zuaw	lna
sxgbp	xct
ihbmq	duh
ssamk	jqu
mgipmg	ivf
kkunlq	eax
pdaseeqbw	xkk
nyst	flx
tefmdl	axh
ohmrqk	djh
qjxvs	lqz
bsdpadag	dsq
kumxrud	mwa
dgnfcflqng	ywf
qffi	lvr
yljx	yhj
cwf	mjb
ksh	ypt
lihe	adp
lmcvtf	lxd
zzfvm	bjd
zlsj	jcb
yzayr	rzn
pnlmtv	eqt
qoepb	kcz
qgfnfcauyz	ryt
wkv	hiy
urebchq	zdj
hxke	vgi
owq	lth
upmcanc	uat
usysc	mcd
jhoujyz	nou
tjqhl	mel
dpxoyxa	hik
gfkvnatn	jpf
hhdp	tio
ntgr	pgv
gfbgl	cyd
olel	uuj
ztaahqt	nic
irfcqzv	pif
ozvbhhechbp	stv
vzzmlbxg	zee
uhsp	dss
noxt	anz
rqprrrmk	wat
krd	jwo
aite	zqx
cjlbxw	def
mtfbdl	bku
gmugp	lzz
qvijyp	sbs
cosqvk	ixr
zex	pcu
twxdsrn	dek
gyvcw	akd
xyiwd	pfv
cgq	rom
ousqbcsvequ	nbh
dbn	uop
wmbq	keo
objbw	hwz
ftbz	nxk
szjsh	vxl
ewvhlgv	one
pnakihckc	umt
zzixkrz	laa
tebjwakgie	euy
bnovoki	rag
hwkiu	zfx
seied	vhe
cjyjux	nxs
nyi	vma
rdklx	ruj
cceqda	jgx
mmok	brr
wlazzhqp	ywl
gjvvnai	sid
bghqox	fdk
ldnxzbuir	duo
gmk	zeg
ykqsxdo	ern
ltkennh	hii
tyv	ypw
dafhdhw	tzn
mvpiy	fnz
iltu	zrz
mgdqce	mha
wkmze	ujt
xzbp	vzw
fhv	mbh
nyvdowd	yad
fuenfvn	mha
sumpw	ubd
rbpy	zoh
oanyzd	jaz
ifshuyoa	jhe
kedc	fzo
htoixrhqti	udm
ukscn	afp
mowlx	hup
ekdqvp	plk
hab	ftk
pdl	dxe
qtdwg	vsx
ookocc	yys
dpnq	xai
eowdfmr	uqm
osbrhojok	xip
uxvlo	flo
cselsx	tiw
yucv	dzq
aofpuqy	dsu
vptwxpkfwe	vid
mbkbnqoq	wjz
edfmpuy	lkc
ipz	vjm
ijdjhdkt	asa
cxivfht	qix
dmnp	thn
vseqrbw	nvm
gms	gwp
ahbqz	oui
spw	gyb
yhekc	jsl
bnbf	tfy
rqamuq	pro
xoqoabj	ppx
jplp	mcj
rzicbft	foh
bxaujeiz	tsf
fpccum	hpy
rwsf	csx
tjzze	gwa
waqewvo	rma
gpbnlmiep	dxs
kzjhjfy	dgp
ovcdawq	zhn
sithz	wcs
dlxjwss	kiy
gvzeb	hat
bhp	atn
cap	gfr
nypnvc	mla
ybsv	iiw
rjqpo	uaq
hjijxz	uht
jlbbflqvyp	gng
duyy	mbr
cdlcw	ynv
lhiwlvysh	gfs
gfomz	fva
ftgf	hic
jbpx	kgi
trlqg	rfz
dnfy	uak
bvultd	nwi
sezdg	jll
uqpoaf	vik
gcc	dwz
qxgckoz	zzl
kbmkf	dhe
oqbxy	qyz
infjqi	hod
dova	wjx
snykqasb	ykl
tejwerh	gox
ktdo	nsy
fkqwvh	zia
juzbsio	yje
xsezfomgs	nki
sonmtf	mfy
wvctm	ztu
wvnavsk	oyh
bxok	eyx
fqbokkrji	qfd
uzhndl	die
rakx	rsb
kdch	gob
mpyai	dfg
cxxf	qlp
sqqs	zyh
imiern	yux
awconm	ves
mgaslo	wdi
oikwj	poh
bupg	pqe
dojrrm	uyf
frqmf	cpb
fghkztr	rjn
gvmfden	duz
zflzdx	ahz
puc	lfk
ejqoei	kqi
piyt	sxd
tawe	wox
biddvsf	iyc
akntxm	gnb
upe	hns
gyclvcra	svo
ucqnuhc	xhp
chjxcwx	plu
zjszfvj	ntj
dupiyv	miv
pahq	zwa
shwqfu	sds
rpeldhyu	qao
qpowelmib	yue
bpvzm	rft
hpfpixd	fyn
zkl	xcx
tovlt	zue
pegcap	ohw
qwygt	tnp
jgxg	kri
nffrbxp	cyn
hkpxi	wiw
noddx	sfh
heqtu	tkm
dffj	zgm
mpvr	rql
torerqjkc	jep
expwx	squ
rqx	lpv
wpbo	fmm
cuasupc	xrq
fhgjbve	vek
ltkr	fyl
lejotm	tbo
gnrohpt	ixq
fnudfwd	spi
yoyren	vhk
mhpe	seu
qzmdbxo	xni
pqrn	vil
jhvu	jwk
qqqxzy	hmu
wnckpoid	urv
cezjb	ojz
kvllrf	dzy
oxfzzp	aki
jsfc	fzy
lwbskf	ymf
ribfh	ker
alzrks	nes
guu	aqp
ggxsebdmj	cbs
wpdtf	qhz
pogpqy	ahz
mxex	itt
crqlkikb	jti
slsgvawwok	nyg
zdin	kwu
qoyolxrg	vzj
dmrk	sjt
jcgvpahaho	zve
ufodigj	mdt
pgfka	zng
vlot	fmk
lijnkt	cjq
ibzsj	rpq
zppcdv	hbb
akuyebr	oac
vmepou	baa
ydcvnna	oyc
fzbmr	zse
anysc	qvf
bvxw	wty
sbkspo	ccr
cfasu	lqr
lytxywq	lnk
zpoeg	szd
zoocoenoyi	nwt
bea	ydz
nen	zeb
pnml	xvb
rsqn	gor
wjrl	hwf
ccoxuj	hdx
jlty	eeu
vzfa	svq
knbeomj	lxp
hcaai	ajy
ykiiag	oxf
ozj	akn
ieip	qds
nzzld	lqm
wamvdb	tjq
syvp	acg
dizse	rne
wghpnez	yxx
cluypdy	ftc
vfxjou	ead
syfj	mpk
ffsquxs	kpb
dbj	jrx
qnqze	aaj
dfr	smh
bvwxqnoz	ica
jpvmaa	fru
dbfju	yca
dokvi	otd
jkpdjod	lpo
thd	bda
krqgaw	emy
crfdrjqquz	esm
qtyrgx	mqc
ynks	ied
ecfgr	jsf
uknser	uyy
saqzw	nnu
ptxojtyk	sak
nukxq	kam
xdh	hvc
xuovh	tjf
plunbf	ltn
cjpheqbnev	jxy
pfih	dou
huivvgwn	zxl
ipziaw	irh
oxfe	krb
vfnrahz	nvf
uqwfsma	vsq
bavm	uuh
unbsb	jws
hfal	fep
xnfmy	xzz
sgk	spd
aajwv	bgq
yfpkai	ptz
nvizkh	aee
sth	lbf
cdoodle	fue
uwfz	fnl
bga	gjf
pijzwd	pss
stmkoo	evh
rzmtg	nva
xmpldp	suw
tvuphbmm	wqu
oqmpp	nqo
gogpenf	wgl
cqlk	rny
wzilyeo	dpu
oznuk	yox
qcbs	wbo
xkfnjx	rfh
quks	inb
ohlcx	fpz
crwz	xuy
xeuung	wvj
mtlioxxen	zch
bxzwvrmd	cld
tpczwt	hgi
cdamw	mow
nndyca	plg
yolqpfr	ibj
uimi	ypf
klogeu	qkt
haypmtoqu	fll
lsgfb	qtj
aopkp	nzq
rdyzyl	jlc
fkluvz	omk
vfqkf	hkx
kanpwnn	omb
dsxoc	kxx
tcmbw	olp
qtwtx	skd
tserblvkd	lnc
dgux	ikm
jvc	xkz
evdpqak	lfl
zojz	rzf
ayr	kfr
wkshsuqvo	evr
edvloy	wqa
pdj	ymt
etikc	uvg
nbmdxa	jke
oalk	ynt
stzipcte	omc
xkoibcxz	brb
uxv	gnk
ujtfg	yqf
lfkn	qzw
dvjlm	vni
pznxyoq	quf
xwhpn	jcj
jordc	dvc
wkl	xnz
rtiizq	suz
djpu	cmv
mhjsvogr	pte
pis	fmb
aofcvbn	uzm
rjdnypfpwg	yqj
laod	duu
zbmowc	bqt
jjiej	qjl
wszwyrcfe	zek
mlivv	eky
cmpqtjpfi	ezm
hescgf	did
jcjhwnp	pld
nknwnx	fda
wvbsqyo	tws
cgaqwan	lxz
qpnfn	gjl
nhzcbm	lvs
lwddygw	icn
icrltp	cdl
mmxpl	vxc
wqvhb	bpl
swk	ygn
xtyt	mgq
wiaxvd	yee
rsn	xba
xrxjsfx	fml
eymzxtc	pwt
ewikg	ags
qaxc	xkn
nzji	djv
ealo	bha
fcmlwt	ogj
wacge	hkt
nmyk	qij
dbcpdo	ilr
ykyilvg	cfw
ltqh	iic
wdtokwz	txd
jamue	lwx
ohavt	ocf
unbnl	fer
xozyk	rxq
wmeokl	rjz
tsj	onl
ltqhj	jed
gcnspi	ypz
hmrsg	uae
vvuoea	tfv
zwvtje	icz
zbugugmk	diy
naflkwimw	xtq
fdg	aba
bdc	nys
bcfjdvkaw	bqj
ncz	evk
boxbm	xel
oxzt	aap
wizwb	imc
hcgvde	ixo
mmtxgka	esc
nmneo	zrl
kvn	let
wtgmdp	jgh
zbbmvesw	uqz
febmy	fap
djdnh	qnh
zewtoxjq	lht
usdmjz	rku
ikyma	eee
odndsuf	hbu
kuhs	msv
barxc	ifp
fpcb	nni
fxsjz	iju
grbmh	znu
kqdxzyhtxx	ygr
fprtpb	xau
ilhyhcq	gtr
yumqao	ium
zbaaua	apx
gsojbrp	ksw
uhqr	gzm
uacrlj	jll
fxmq	dor
snqp	gzn
pdfs	vvg
fxcss	guu
ozj	vyk
joa	nua
zroaokblb	jkd
rmzdlgc	pbr
avht	yjc
uipi	ngy
rbrzdti	cyo
vmrv	ckb
jvshg	bcb
ruoicakp	yru
iejhreh	obd
thqsjkd	zgi
rojpb	plf
yxoxmb	nfr
srmot	xsk
pfazcn	skw
qjlbxhb	zdl
xczue	jqy
fsni	jys
evq	ngb
kotrthzr	inm
rqngnmmcxo	ezt
kriscoo	pgs
qewma	nwr
klzyvl	mez
vyalpfx	lkw
dzew	yig
wovdqwn	hyx
cjmri	rdk
hugvyg	zzu
hiq	msg
aoqzuha	est
utwnm	avw
upajvnpp	xto
paonn	ymb
uuhpmwoym	zpj
imervz	yvg
yvriigp	tgh
xfhfhyghq	hap
qxecq	zim
tebbqr	rxe
ngfi	jzx
ppuppx	gne
bxrufi	ybp
tpcg	ckh
jdkiwiu	vnd
kkbhyn	aia
dvc	alm
zdaau	ukj
vpyqqp	hhi
npyqa	txk
ilhrpzif	ouo
jiad	quh
zrys	gvv
bcxama	hpr
bzpbg	spi
wmanwfb	loc
ppexbo	ecn
slc	zjy
zjhxnsa	onx
txozy	jpz
nmlmbc	eya
rfx	gsg
ilqysi	byf
hnyyk	jgk
pjtxg	iss
dqogfzvril	nfz
aljkxi	lux
lmsnksta	ouw
aaywghl	kjj
itvz	teo
dylpaw	yyb
tpiw	iqt
jzqden	tar
mzxxhpj	eno
kwzle	dri
jfgli	odn
mdyr	pkn
jlesjxv	qzl
xhmmfa	ehg
gcnbrfv	jyz
lgvrzkn	utr
ozee	ogu
ruzlupbao	eij
ndwvmmu	gsn
rskq	kdt
cmam	xej
nmuwk	dzz
kgqdxpbn	bfd
uprw	njd
uugyya	rzg
bfkm	brc
szo	shw
mbovf	fns
wcaxuwee	veo
mfztut	kbp
mhsiqx	iff
boxc	nvp
kyki	bns
aqhy	acb
kvy	afx
gzfk	lrx
ejkfcxsvda	yfj
ilpcj	lom
htod	hyl
tbiih	ria
mkbfda	ydn
gxgdll	nhn
srfp	yxd
qxxhwy	pjh
dtnstrr	gbr
arbf	ruc
qclz	eks
zgghgty	hzl
tgznsn	baz
rfwu	kyi
wqr	nvs
aevfqji	tjs
rxgz	wmq
pahyjwc	hut
tlkehp	dap
dszta	vmp
gvmosuc	vai
cyiguq	dxq
nux	seq
bkaxg	djm
ciomfmu	dyv
gkhzyphm	rec
oryffbm	png
ejt	roa
ktslp	yaa
rvevomjc	cbv
mxsdoeh	kmn
sfcho	wsa
ruscfsa	utg
owpe	pbo
iohnloonc	ehb
yyyjct	pwu
whw	fcr
jmyvsje	nwf
gvvshm	ero
cxjmpa	tuc
htqpr	jmr
ndmurxadjc	qrb
jmuopl	gmx
oeuxh	hgq
byrr	avq
pyinpt	uyo
autyhnf	vgd
vnzwdfxvtr	ovn
pypr	cme
oxowrg	zhw
koxekqsa	iud
cfgfm	ske
cqe	dym
deigq	ipt
wiyep	kxi
qixm	nwq
vhcm	ema
jiw	dlj
ksj	gwf
gcifeacwq	nll
lsbd	bxa
jrq	vyk
psx	ywf
pcjbv	bbu
kik	obf
eyb	hag
bpbj	shk
berg	kai
swy	nim
qisxmjo	bao
see	lcf
rexp	klu
kaqvvei	rnx
ytxcd	orn
hfql	ncc
exyqzxac	ecc
lwoafdgb	glq
jnrq	alt
fyxlnwlw	ijl
okuwfur	lmx
gyijeh	yik
ujooygk	khs
jhtalo	zca
hlibn	jyv
joyeew	fph
hoczcfyek	lok
iefaru	vwf
pucsov	uby
awjbu	sxu
wmntrb	qwn
xddp	hkj
ureg	cza
oxvpqcgqta	dzz
jkpxyht	iaj
mgtmow	juk
spaxu	rmc
tnw	fbw
rnzpqa	vkz
fnarxc	nlx
ylcu	zki
mipzgs	duf
phhyp	hht
qtxtaz	osa
hifhn	xwj
yxp	qrc
axflf	qij
tchirz	jfl
jtqj	gjf
mxnjl	eww
xpsbsac	khv
cqx	bct
uicvav	kze
jqnuxbt	hcb
sqoshu	tvj
knwgwji	bng
xfzhav	xgo
ungmsnxk	syo
dxpujvs	vru
csdboqk	vre
temo	clt
vbyp	dhf
ywhuwmidy	fup
ozcg	lcq
iwbdk	pbs
ogrwh	lqs
ppnvsaj	jrz
ijbqdrob	eod
sahrhnnfi	bcm
zswdsu	eci
jhlw	qir
ypsdudv	fit
cwwr	dtr
moebnq	vcw
ruculi	myr
pcw	mka
jcv	lpa
qehpiujf	rai
jwkvfx	cvg
ycp	kse
xwe	gnv
qewrnt	jbw
cll	jdy
hvfu	dzd
xejd	jkx
ugcdh	tay
cyeak	jph
cibw	ezq
srzrwh	hbl
pgw	vtp
uzd	zow
fniokhf	cdo
htbxshzu	uuv
oxyow	jio
ygudpjc	prz
nivpxk	zfg
bzq	sxi
qroap	pqf
irnabm	gcq
qixyeu	guh
bkquo	xkk
iganxg	cau
mfwsw	oub
nrbn	bnx
ach	gde
bpgjfly	lne
wwwnn	lkl
lcqmo	uzk
yabnkzb	zmd
kkmig	nax
oso	zwl
hbctldnqz	act
yla	foi
zuoms	djv
jysjb	qln
kiuqrh	kkr
pvvzsqwe	tvj
gkjxcui	npn
wyqkcss	uzc
lqgv	xpq
asccrlu	wcu
ylkdvq	djr
ypxneh	vsk
ufdtmprsy	nxf
echn	luy
qgdj	vvp
qiidzbv	lcp
zbb	yns
hgajvom	uyi
sbgmotpc	dug
sulk	zfq
rkffo	hdm
rognkda	nfu
pboho	rtp
plpvffny	wko
tucey	jog
ypfn	cop
rupu	qqr
nsavg	ccq
ewbcg	bug
qjuqye	zcf
zapu	vhe
uutr	xpd
ydbgshce	xqs
evr	ljj
umrttvlng	lwn
cyovoxh	hra
uxsxr	zpa
qjps	rtf
rxryp	jeh
uzr	fec
tqrc	jvi
wjtbib	lbw
mhod	ral
euwiz	esy
utsgbd	tdb
hsifqu	loi
kmh	lqa
vbyocaglz	oby
anrwqe	odk
qdzqdsev	wmv
opesxqmb	pzp
bwsefhgd	evu
qitvekkg	bdt
mxkydn	siv
qyrq	git
dwppzn	lqk
xejaq	pej
biicut	nnu
hqtugw	byb
hjuz	qtk
vdvcy	usb
ctoeb	trz
mgbkrbkk	dfl
jchgrjwl	xez
tptiplq	arm
wlwxn	rjt
zuchvyct	fnm
honlqze	thi
ief	duj
nqtxfufh	tfh
dni	ooc
ndysemth	xnn
cvttv	roh
gfhgokf	sny
ofmuym	htq
slyx	dwa
dpdo	exz
kzybh	npp
ifu	fhh
pyyx	tgj
wiisjpcjv	xfe
sci	pgn
odahcc	hsz
phht	vwe
qebij	ttf
xqymdtevg	kjm
npdqsvn	ohm
vqf	yan
dnmch	lgf
wnatkc	rlt
nicsdm	qrw
wqolju	mkv
hgqmqxj	kkp
tpkto	euv
qfkeqq	kcr
vjfa	kbg
gphpseac	sbl
yzgx	drg
bqgfaxp	nbv
wmy	pgw
grw	vja
bdmlet	buj
unccc	ccx
gcqdf	ptb
cwh	gpu
xpr	dxn
hrsbzo	ovu
afdwn	uew
prcc	hzc
eomyu	gil
kdoyk	apb
ntinzmub	pbl
yinj	tiy
brxmw	zxp
psy	ypu
zentru	yqm
fepibh	cjv
jmronicybv	ota
btaqfenl	wbx
aeikt	ccp
kcqqmn	rik
huonf	vrd
symovar	tqa
iegkpuq	qgl
okftegs	cbr
lfnjhksl	qoa
wtxzsnf	nmm
mungh	rsa
huyssv	kop
cdbjhi	vqn
pqap	ngs
zyeknb	vyb
bdt	nbz
nhizss	tvr
wyzroz	dvy
lcwopss	zdx
mejnlva	rvm
xblwt	nnk
xgxmojmh	xql
curukfz	qke
vnkjs	nll
fdpwaacrig	gxj
ojiyf	xqa
zfpu	bvx
xuof	lqt
wfdcy	iwl
itmuvs	cub
xqpkk	qhm
qjloqew	ijj
ivgehc	uui
kvqylsyn	vjk
mbf	wqb
teaqd	fav
ntoqfuece	uub
uqzrdwf	xni
iwqhc	ijs
vysk	rgy
wih	qtg
dcft	tow
nhztek	jst
veexbp	bcq
bhm	zuf
ugik	xfq
pxiah	uox
nzrpo	lpe
fwakr	lbd
lwnau	cwt
bns	clc
carout	uxp
kzkizce	ibm
ekapsv	zin
skjejdewaz	mux
zndmceuri	npn
adbbliegd	ejl
tjk	wal
ytutce	odn
xllsxl	ixu
jhkqbx	peh
axzpi	jnl
fcdpgs	kfv
jzjzyw	flm
wefsk	fsx
wlsdlv	qtg
nds	lsf
ljxroiy	rin
yzaig	hea
jmapw	jid
eayzg	bqx
hycpibc	lxb
aybsuj	vde
bbermbb	izi
tjmsz	ygm
qjh	utu
fzpk	dyy
wigweb	dse
djipixxj	jnd
tftaapm	zbe
drqmg	nyk
ulmmjc	dxs
kkzrw	nvx
jpdq	qtv
wghonx	htn
gjgc	yex
gonoxj	eot
haqji	ybx
nxokkvy	xcu
tmsvk	afs
nararqta	jfs
lueg	sco
sojjeunl	mho
mjhv	nqg
rprc	pop
faz	nsp
rakjy	kzr
zswpcjh	qqj
xjdaeflh	hxj
iotpm	ftf
rnidp	ogk
rko	kjk
lmldziebkg	ntf
afk	gae
qknmwd	ibb
qkykqj	eia
ymsoe	tfo
inxgp	yex
liqwe	tcp
kdeqohg	nyq
wttakj	mbh
ugpye	aot
tudpbu	czs
tmclj	wml
ylugx	wah
vxgci	yyk
hcvcijta	tqx
jwrxtun	lxs
vvemq	nqj
fwkp	wut
bwcvksb	ivx
mlmqd	sfv
tjgaumop	vln
njfog	gsd
jixmzd	ryc
fda	qro
pdxk	jcl
yhyo	guv
kphfdo	nkg
vjsu	cle
ktvmgno	xos
vrdo	vrk
nqx	zqo
cgixiz	pmz
qqw	zvl
mbkujb	aby
vntlbfud	bhh
pqxurdjjkme	eit
yol	hns
kqffobeex	nxz
ycvhu	pvd
vwjmtr	kll
odis	yqy
nyqphkmu	ihe
lelbc	ycp
skmoiwy	qum
vrrfz	iag
eyvstynz	gmg
aelgwf	zfq
opbrw	eea
xxsoqpt	dud
zxfvsfi	baw
tzjzeh	wrm
krl	iqh
ozzvqkvm	hzl
ozew	nxv
mhdrpup	npx
yiqithxjj	nfi
kqtupp	aug
gfzoh	fwo
bxf	atf
avo	ovz
dadrke	mrg
ktyraw	kfm
kumt	mtw
cinjlo	vuu
eykux	kjs
mbwakvcm	cpg
dxdy	cpd
irs	ghp
qyl	mej
gwtifl	snw
hiysek	qvs
jnmlsk	ifu
ctvsqy	bbt
ijnxpz	zjx
dju	zkc
radda	hmh
kigiwd	egu
ltuqt	ofb
gxutwi	ckq
mafwii	nqs
udum	xye
oekpcmp	dfx
alm	lqh
rgza	oln
wcwgfh	bos
cmzzr	byp
rsbzlh	srf
xjrjxq	gku
hviwqpao	vot
ngmdv	wpf
sdonov	rtg
ktplad	bes
rssujlj	fev
nkwictq	lon
jiwf	uln
cuocukom	ykx
bjyf	sgq
feyalp	oho
tzhm	rvd
xixww	bdq
uumaqgk	lof
lpwds	vou
yntx	eur
qrnno	lqt
rkbxp	rxt
mwtv	pkn
zbnfo	bhy
qmuo	pci
rlvvxo	qgp
eyxuhu	frn
tvi	wuz
ecvnm	ccf
rfnif	aeg
rhstr	czv
aawz	nmf
puat	nbl
swwj	trb
jpfavpba	plt
ssuxw	acf
xngel	pnw
fjlpkq	jov
dqiz	wkx
pzia	sqi
yvzyoh	wfn
bpagkfv	ezm
cujo	xwx
llfpfr	wjk
epmqsef	qmb
bfwfzbu	rpd
incoew	rcd
wikt	osd
wtfaj	iaf
rqnnt	mho
sukn	xff
zvafxdqq	pym
qyvd	lmh
gou	sro
gakek	wmr
vszkmj	jad
xcwtokw	nek
tnnkl	epk
bcikch	iek
phal	kej
wpatiwki	lil
brct	jci
rislpnx	vup
vwagc	vve
oggchm	ksa
fugebb	hib
vmgah	prw
hawiquk	jaw
gdvflq	yie
oovat	gje
rsqlyxen	ucd
ontsok	ocx
owgsrx	mpd
dcgrt	ojl
jltly	ita
qfkfwawn	gqf
dzlm	jpw
impuu	mky
kqgxcxp	uzh
khklo	ajz
mrvlc	ihb
jorg	utw
eyne	vze
xoswhf	mrj
jcgtz	uvl
vognepoffz	ujn
zmqds	ded
ryfyi	wrv
uuwwt	dxv
rijzn	tcm
newr	djw
sgdyq	acz
vfjd	zsq
szyapr	omi
tkfttd	lcx
esjflq	obp
sgrle	htj
jkudzr	scx
hpcus	qnf
bfyo	czc
tziwae	dnl
suqfnjh	xiu
ckvocq	mzs
wgvxc	gni
nqre	nfy
ygvptk	tzb
cleyrrv	kjc
gtiwmw	fpe
tkxbf	cet
geiae	yfi
bjxxrlxwu	xfy
pvs	nmt
kojorpsodiz	eki
fuzawns	ttn
yvwizwm	laj
nibxasl	stp
tzlzj	ukm
jtr	acq
dqqgy	rjp
cwyjfhhg	hpt
jimvpdy	eph
hlxnfv	wqi
tbaau	xxn
dxhajchtr	pwc
zzmgpbnv	vcl
xgzhu	uog
mtqorqte	lqy
gcglkbn	flm
rbhjyf	uke
rgrm	epx
nqnphacl	fsy
vdu	mbc
ehtqg	jeo
qqpqvx	xch
aapwmhb	asr
cyxp	jkg
gicdj	hpu
yiiglr	wss
ugtquwv	dwb
frs	iob
feoo	sii
udvzptd	tqk
ofxd	myf
airwxyx	del
yvgqdn	edq
rwufxgr	tsk
jexg	jxo
zljio	lln
txfgywmfx	bxi
jtfpp	boy
zfgdezwb	txx
qptdwq	zip
hwl	ppv
baxl	nzg
nhxvipb	jyn
nnc	dgj
fmqkeyvps	azt
ottz	bkj
vwtu	cnd
ymvbdq	hvt
rczwkx	apu
jvpuq	zxg
sowtnjcn	due
mjryeba	fxu
asmccn	hez
dsoz	vwx
mmpwnjn	euy
gafcls	jyi
wstb	fhk
vkqjp	iai
znzyxna	dyn
rczloywo	khi
cqzch	osv
wmxia	upj
cimdhja	aoj
innuaji	jin
iople	tft
pbfmxa	chp
weftcxn	frq
vhih	lwb
zlpumh	vws
kfflxhi	uqe
dkv	xah
rnwgz	sku
nulfxo	pnp
zdknsr	dxv
mrpfrav	bjw
otp	xop
gdyfrfr	tmr
yqbow	jqm
nocrlg	nwp
pyazr	ojy
exslu	aep
tekcsqc	vis
naqn	doy
vxrdzn	twd
irar	cus
nbiaucd	jpf
esqwr	cvg
wsjdr	pgx
jrpjwx	uhh
qkiobmqhq	gpo
gdjzbt	kuu
irofrn	sra
qpqigj	evt
jzsuubt	fct
ljoax	kpx
vszsymiu	nmq
ltxea	zjf
ymbcdjd	xgw
chiem	aii
tiyllk	ofw
kllgi	ubn
psh	wbe
iwtuxoc	psz
bjmqnzk	oqr
txeprsto	qse
qmmyyj	ojt
ultge	yis
mdtvjq	ztv
rcyd	iow
kbfs	dxn
nqtir	lsz
hqmlscz	ygx
ysafxvills	hrq
laec	jas
yce	khl
jgev	ydv
vqnkkoq	ozo
zvwhlf	uoe
svbhq	fsv
vhwbyx	gvi
tjr	aka
wftap	sga
ftmbvmf	pkg
mffkoa	nsx
rolb	jym
humenhwv	osr
qxlv	kcl
qvvf	qrr
yeyogda	cds
fkkeq	rwr
eqbn	tne
znnvwg	bvt
zfxfhueg	ozn
jqljm	djs
szsyejiq	rcv
wcf	plz
nqyuaf	cmj
bmjwztl	uyt
zpivya	zgz
xzgpz	lrk
zcdpkj	cxf
bjlk	pmf
kekyt	itr
kcrzqh	uek
kkmmboa	kit
ntvvyoomx	qno
zhuprof	yqh
cjlukbuyd	kol
oymooibg	mpw
toh	fbw
pvgrvlo	xyf
nknxe	igi
inwgnr	ouv
jchb	nso
pckjbsid	esg
zihjhp	dff
qoqrc	vpe
feasydg	lrq
btdutj	bmg
osyl	hss
dckfeptn	bpp
lymavoz	icg
zda	tnp
pmvh	msw
mar	vdh
xfgz	gfh
njqram	huo
dxqkqe	hag
ngzntic	fxr
gnju	dor
hnzab	azv
zdqwget	heb
wswjlh	hpw
ffqryauco	scz
mzywliv	rgh
irqwqh	vlq
wvsrskr	nyy
gipcuuugc	uwv
asgvf	fwp
dynwpq	aqo
dmecnqg	arv
rgogn	lhq
jakcflo	zgm
drkixz	xrf
sqq	huo
eng	nel
wfyxvmyg	cai
nnoaj	ydd
bukpxrq	kio
eyt	oyu
smm	ccc
eatii	csg
ghrlcxsum	eix
dtjxxmnl	jpg
puhwlnfy	bhg
yban	lrl
fgeketu	yle
urseae	jwl
nezpimoa	fha
hxpdgsc	fxs
ckyboa	xpj
ifdar	ysu
seffzodr	til
wehciwij	sik
sfooqel	szk
bicuod	yfi
lwjmptmu	wkn
vouakiqp	buc
aabsk	qhv
mrpbvln	zqu
hsii	plv
iekjoin	cii
jnrpl	ugc
twddd	pco
mqohhbg	kks
uuecon	tlj
vncfp	evt
wajbpv	efj
mcder	ewt
tcikqmy	bsm
qsgg	ost
mutfykd	fnq
ijxgy	hsw
ypph	bag
faibew	epn
toxgddlhp	ggz
ugfsr	ccm
jwvclu	vte
cbw	jjs
cznr	yjk
suulfud	cet
ekqikjz	sfg
fdwzp	pjv
ivb	bud
tvmpzhs	ltg
khfgark	nds
cuxjyk	lfb
nnvkr	rao
tolp	vtd
kgssg	out
jkahfnj	mvu
fzimadniq	syd
ujv	ymm
dhwsdcxj	gpd
pgzjqsrj	xqq
abqhikhil	pdl
vlehkvu	iyf
iexsw	gru
ybiu	lix
mrrr	iuq
ronfx	zvp
ndxrtjo	vqk
uoxz	oua
kiijnbykshc	axq
ldbqqcj	buv
lfrbg	kuj
eunuyna	koe
nrxw	nlq
fnkwykb	mzl
kzqyi	jic
tzmsnk	tet
fkbh	etx
kmbhyov	txp
scrbxp	vir
etruy	npv
fmt	icn
xcln	nrc
tqeo	mee
nvbokhv	gdz
eqfkjn	xky
sii	bwl
rtbyf	cgz
bkrhdt	vtq
mixazx	alt
vscve	zgv
crrvtdggt	ulp
ownoga	kdi
lwox	ycc
uejrh	tad
geuah	urr
iuxmy	isa
cbfvjl	goh
runns	ive
nckr	rfc
nzyyu	fen
ienwpqz	cxh
nxlcjpf	elb
uyqfgw	xkc
egcyu	jsj
xlp	mna
btpfr	xrc
lbpit	mdk
dxzuxy	ctm
gbpqk	jck
ezjco	lom
krjuu	bui
njrtqm	pxv
ihe	omh
dosj	dcf
idzb	zjt
yhni	xxa
xnsuca	tbn
xgyv	xcs
nnwfttl	mog
jtxqhutn	xht
ityiz	tgd
mtexxn	twi
oemkfsw	rfj
gwqezk	pxx
qsuuxybs	xok
qbftrkq	pgz
fgbvrp	pbv
oikhjipfs	ere
avlt	cmu
pewnnhg	ily
tlrmawjp	mul
yqiwhk	wao
gyhhwk	cvq
bdt	ubs
ppqr	cqa
pmdh	pfk
jzojd	sso
koovch	jye
uqwprgjp	foo
phj	qrh
tbncreqyxr	pfg
xzcrwl	kzl
hhv	xbl
usizlv	rrl
iuqu	sjh
uarf	zki
vqkg	cux
yurl	snc
orud	zsc
jpzth	gvl
rpse	umy
ydbney	ixm
pvdnfbd	xft
tvrvr	urk
mahu	qbt
fwjmjxcy	elx
hjv	zmh
hjcny	ivv
kry	nlh
jifrh	uqf
rsrgrtb	vsp
hmmmutl	nvs
gxphzoj	oea
hvl	qej
fgpstm	xsb
ibqsb	efq
mprv	ntk
uzroujg	jnr
rwqhbmwi	vbc
zpgndpu	rid
nouqo	fwq
irxxhlmjzx	sff
ajwl	poa
cowy	bbm
zvtxxdgq	jlg
wtfsc	pwh
xom	tpu
eyqndl	hsj
eyo	ojz
bciu	wlm
doj	hua
bit	byl
agpup	wne
uxfl	mkf
camwf	xca
aqj	hxi
uqgv	xtz
ukhexrr	uwo
pcscinizn	whk
ykxge	dky
kecrpf	uus
ogqdz	way
umoexul	jyx
wwm	kiy
pzbakir	dzq
yszuyd	iyb
kfruh	eye
axpjuvkz	net
auko	iuu
lifiyi	gis
kqrbqr	yot
snfvq	izs
amu	cuw
mrf	ilf
lorqfh	tdu
zzxgv	xwe
nmfrtzfdwn	dow
ntkc	dzy
dhxmyx	dre
aegtgo	yxl
vqigl	gie
lkxi	dsc
dnaw	krb
rnsnat	wex
gczbdkboyq	rng
zddcx	lcz
gsxqfxm	god
fwm	zxe
mcfamv	gdc
rdfexy	lxs
jnmxkwpc	kcy
dmqkjlhm	bbc
grhityy	tqw
hmqj	otr
sxgkjz	bcm
hpydpbq	std
lplc	dol
glsqde	ofx
yujq	etc
lslqfif	kii
ruuxdmhq	zza
kwvib	xkx
bjiuj	raz
aiavknli	wce
yszkrdly	eid
buogyo	fib
oraftqjph	xtz
svbp	bnl
viajqrk	keo
uugnjs	dbl
jogxuu	tmg
xvbt	lik
xycazet	xtc
arcld	mrw
fcizfbx	gff
fyi	zln
gypgcj	alc
rnwmfsiiha	xyf
dgyi	son
mnibznfj	atl
mcupidjr	hhv
esfgp	jgm
yzbinh	vqq
ktnilyot	pih
jrxrxlt	zll
thgsq	end
fqxr	fcm
ncsjmsw	ovc
err	wzf
vkzsi	qgz
fgm	old
tsqco	urk
fhfth	kph
zpyayo	zhb
rhis	age
djuz	yld
rnugjr	mqp
dxjgm	bgs
nacrkk	jfa
vydoh	aib
pauii	ivf
soalcti	sxo
gufhyzrm	hos
jncl	kem
sldoscdh	qvl
gfckc	siz
prxp	pqa
oadsxjly	dwz
nkhpw	vyt
dktmcd	wmv
scpxpqk	uxg
gdcvxhczc	var
zcyvi	krl
mpc	zap
qspnjfd	slw
qhxczkhix	ife
ccwph	crt
kqdy	doa
ymiuh	xts
hsgzk	fnm
sftip	ugv
cvevdw	vyu
vqwqsxnsroh	lnr
cyuiqyzi	fhh
qospc	ssw
nfscb	jcx
qgwguzwel	kjv
ally	hjo
nfrh	igj
ipgt	ncd
npch	luh
hnztthb	dah
xxblprf	sat
cewdici	jkp
lspgrk	xjc
snoeodw	bte
yrop	mha
oqbcr	kzg
kqprdk	gmm
oseab	dme
fsyhfxcb	gxb
hfdjczk	ehe
qcsz	mcr
hwyswbio	laz
xxsfhc	bvn
euhmccl	ndc
qnshbu	rfi
cxch	sdo
yrg	prx
xnlrmxjr	slp
htobnc	mqv
euzyiktfb	zov
lsdlodk	ztx
wygv	ibk
dgmmthr	yvr
ynuip	ajs
ljubeyterpr	wfw
hdipq	ewe
xwkdd	oen
hgmkvd	soo
znhatn	xqp
qcxpvm	eud
tspese	dqf
rfwd	qyc
qcowqnfvm	wac
jxcrikvg	lpy
kyieuc	oji
dvqxpe	dxl
nrufp	giq
iwvvfl	lrs
bnog	oig
hgcyh	ima
jtrd	tsq
qfud	rxe
pvymkqac	bzo
nkdj	fbx
komqsj	rhv
iusd	vdh
gpbfbqw	bbf
jqz	zdk
akkfo	isg
ralkeequ	dpv
vpiezq	knf
gnt	jlh
hzknbl	mvh
tpzclf	fpn
bjvew	lpg
xlilcm	ffg
owjjzxft	jrd
jhmf	nba
jsqjwaxpi	jnr
dqlryt	nwj
ejvvzf	xlq
rikuvba	xtj
vsayr	yst
lexkf	alt
kolwp	qfr
whtb	mlp
wtxs	sxd
nkgjwu	kly
wlqei	scx
eaxfkju	fyt
lmw	jbw
hccaa	wrw
fmsi	mny
spvihnxuxo	qxc
cmxv	sjt
kszsncb	xcw
zipcid	vuw
fxq	dta
hvli	inr
logqdxf	csk
kgdtsh	htn
ohjvqd	bgc
hnostj	ivs
gmassgyux	zxz
rimkawzlhy	ywn
rtlhyfq	xfr
kfpmbhdd	yct
ipzk	unx
caygy	kdn
lzksci	htp
fohsovg	bql
zkadxxnms	nra
qrzszy	spd
ihoxtfs	yzs
hzzzij	bfq
hqwo	vxj
wux	dit
ndhmyv	sbm
rrjg	bwo
mikjspt	obw
susga	bff
sxlzyw	pfl
rjqfalbmy	koc
pqzalvw	uau
qbaxr	kqb
njhkm	vji
qcixxkf	awg
khmhu	rnm
xwggpl	snn
esp	vri
qkhmk	bic
dtod	mxr
etusyc	irq
aayfmw	bup
vxwyflt	svp
hxvmtm	fxa
bijgb	eiv
oqbx	fyc
habsyg	axe
ewwxbzp	xmm
swlzf	epk
kuxzs	ctc
sbyrobev	adt
iad	clc
pzbt	fnw
jpnta	czh
dxx	ypv
gcslj	gkc
amaae	wrn
xbcimw	sto
wmkpno	vvi
fpawpf	cco
hithdxy	dsv
edrbpnujxgq	ifj
watrydw	knd
vyrpol	jxr
emuj	lek
ocrfn	mow
daxynae	syd
oarhjy	dtn
herqgs	wbd
abatybzf	urt
gwoejmb	ycl
ivtkcedw	pdw
kgkq	gsg
zwvaycy	dmw
esh	tdp
tncn	cji
zsykmujazo	lwz
csmkhre	ouw
czm	vsa
mmoam	btd
tuc	xrt
hsxwdzy	ywr
ebua	pbk
nidkzedrm	ogc
oipw	vbu
clqpiwa	sxn
baolrdpjm	lig
mgkmyl	zah
ltuja	gwm
fekfo	ern
riyh	mmv
eocxvzt	xiu
tlzh	gmu
ndmu	fsg
pyojb	jww
folnh	ggd
btgzkujb	ion
gaksd	xaz
ywlsig	otg
haxrnrzd	jur
pvdx	yft
xzomkfjy	wri
xybrk	tyx
rtldhueo	iqf
pjhn	vlf
axis	tdg
cxov	fcp
eexqp	zgm
vptb	sld
bceplqxg	duq
lziqk	zvv
wrahr	icl
nfeggieip	zcm
cuvtmacb	cfc
hwogtgm	yyc
znisr	esf
vrmrdvm	hdk
jjw	ocl
kjwnlv	ajv
qbesl	efx
ycbaus	niz
digth	mvd
lyhph	yma
bwkbd	gdb
fvnwwuac	egh
ussx	ewo
bdyr	wdb
ovg	zqe
xcgafi	cme
dnquszu	sca
uqzznjf	rtq
tymzlyy	pym
luyuq	toy
jecri	luc
jzdicwi	kvp
eronp	lmm
pioegr	fgm
torusy	hwf
nesjn	sis
zvhj	bga
civauwrz	kyx
pghdakolki	vdl
mkcfijzas	kvp
qlqjen	pgm
rgqhz	syy
pamxvx	ztu
eafo	jcg
zopt	fkr
cfmz	iby
swqupr	tvq
dyffb	mfh
rdvoti	lzp
ntqx	yfh
gss	zsc
uryqydbv	pha
ftyht	zmz
kvrd	fuh
rspqx	klx
fgck	jkp
nvvqojwi	dqo
lxac	col
nisn	per
jqphkn	tnd
nzqesxtj	ayx
ljbix	sni
cimrc	svo
fsczudyagr	hdt
wshgbyivr	rsz
cxipulq	jvl
pvh	prd
fndaugp	jvx
vmvquq	qfv
qbqijh	rex
thdrgy	zpe
rxyrhzbcu	dte
luhnkke	qsu
fhvdj	qlv
gltrkwnz	uzj
lrxuydl	zem
vrghp	luq
hwpv	llu
yaclswo	oqn
ekvp	odj
xwu	ugq
wmblh	wnz
jorhttzt	lrd
ulytq	spm
nijtxrn	riv
kqvxck	xlr
tjyss	lbg
clirbge	wop
ynfev	ceh
ygirww	aqh
akslaq	tri
neveummi	bou
eiuxwxl	upi
qlklpla	ltj
gykkwe	kus
gko	eeq
xiuwxnx	grp
feyuu	eye
hdsgyl	cst
qersr	pav
zmtvbjnk	vnb
elbedsqmt	mdz
buifat	kje
mrfcoi	hwp
irsvgzhr	ekl
ipumpo	wwu
dpne	xoc
zvbnkvt	myd
wmrc	cox
ces	wwy
birjmr	kdc
famlu	wci
spuyvbk	kzi
lyj	qfp
oygyv	yae
bxdbp	amy
wvbkok	zdq
ocj	yrb
hxcbt	hip
imufk	uhe
ragahgqh	pek
jruce	qbc
eqlasd	vdi
ipkqrx	ugj
fbjy	niz
syi	uhy
wswhs	lhg
wzarjz	vbl
cpmx	qeo
mgrp	umi
hhijd	wim
xgzesx	kyd
kchyk	tci
rzd	kik
ohcutb	mqh
omhlkj	msy
oqsm	ywj
jlyvbxq	uog
eiorbm	gml
qfrftcx	uae
exc	vjc
hsxb	yta
zultnpr	fqv
juvt	ldp
pbvqdeytwr	ivr
qrnkv	vxu
dxm	afi
msem	uhm
ikpdnid	nbt
mcbn	xqv
bmdsk	kzg
qutqk	waf
yvd	odx
kdafx	mgy
bxrsbxpd	fpo
ldohzb	opq
ydlwahc	zpx
lry	hfd
fbmyv	ynd
imsacd	jaw
qase	sat
mywuq	drz
dcpj	xbt
vlwhiw	ysq
plp	odb
frnvls	rpc
skeli	cda
hogp	hiw
fhmwvmw	ubd
cick	ezx
xcsr	phb
hdveu	bhj
ffepb	wav
jqtg	mnm
olaba	edf
kodtvsnfv	btq
kceq	hhp
cgb	byx
egmqphp	slp
pkqmmrvoi	amh
nevxzj	qji
nnqvj	bso
bnvtt	ieq
rbpvffycx	qxk
cgjb	cgz
fsjwflr	kku
oqwh	sqo
dnp	gha
wmigo	ywf
ipe	tcs
lzld	byr
ftnwwv	uid
gfwuqdhu	iil
nxovqe	nto
kxq	iui
hpvc	sei
wymn	xfo
srjodvh	wxs
qkwvm	usx
zjfrv	vks
kxbyb	drd
dia	lfy
fzepfce	vic
rlujpwdb	sfs
jczzxfums	yeh
uwu	vfi
hfjtvq	nwc
fuo	hlv
ysavkdmx	mfh
jamfaf	rsq
lmotdvjy	ted
wldvodf	lko
yala	crk
idevxz	tdp
xgeoegeyc	mxc
maii	ihu
wayf	zyu
veyyhkwc	ijq
dco	eaj
peqvvgl	pqx
qsgh	ive
desraitl	lct
fleh	adq
ixmz	gkj
frft	sho
teta	hnl
rfttrakb	tes
eecpcpey	bqj
ltqgygy	plu
xbqlfscl	anr
mfdpysgji	lgn
vai	twz
nugs	ovx
gnnbc	xux
drarpv	nis
gzsjh	pcf
bwws	wfd
ojxuncp	aha
blccvo	dmz
trsk	aml
hzgy	xan
rsj	bih
bbtd	lsl
otpcbsb	mym
obrwlbo	hng
hzup	fzu
mqubbt	bon
knwzpfcj	rqv
fxucku	dbb
nrwiox	xba
tkcdsr	foq
edpeg	ojj
lyhtcfj	lhj
evyohz	lby
hesf	sgx
pbynfala	ztu
rcvn	aab
dbzhe	qsm
ygqoxrt	gwa
aciibc	dqw
hdbs	bns
uxcqt	ngu
fzpnzorwa	unj
vvok	rax
fiuazjk	woq
msyv	qqr
ezarnwvpb	cex
pxlotibv	oee
fezxxsol	xld
jiokc	ukt
swng	ijx
itkijsd	zaz
hwusa	vyq
irlqo	tqs
vlnzj	yrm
iamn	bry
zvyjq	cwe
toucdo	grr
gznwse	vcg
fkbd	pcq
bgqyu	cfa
vnpsvr	ufr
ubuugm	ysa
movar	mvg
gnbf	exx
plrd	ycz
vnqrzv	pzp
zynr	zxt
qmzlft	qcn
rgirpgi	csg
gext	ptx
behzxcwa	hyo
nzzukxbm	fjw
kkeiyuh	knv
toxit	xoz
djqzqyagk	gbg
tatfb	xls
ypq	uus
yayfle	ggz
unaxgalkn	xks
amq	foe
uvxgie	qwk
ccaxpx	aeh
lkolarwb	rzv
kqggwsp	hbg
cko	yuc
issjop	cuv
fhnofi	zls
afu	jzc
zoxa	wej
zdheqkdk	jzf
itpbtkdw	vns
lilor	rpo
vzr	cgg
txvpvj	knp
jlhvsjs	bzx
upurv	fxm
bglbbopw	nwh
usbkyu	srv
pczecz	wzp
gyimqsl	pie
raeoze	nyt
kbtns	ssd
mbil	avc
cgastq	igg
svkawbo	lxc
swroc	ubv
dfco	pzz
joyaus	icg
mpuwd	vmc
tbppf	otv
xrmojnelj	was
wyx	mfd
pmdgf	nze
flolvebu	pav
vpffpdfg	oiz
ddn	lrw
rnqr	xew
xfyfag	yfj
hxpdht	cse
wpxeolsmf	yti
ayrm	ztl
kqybtv	bym
uktvl	zys
ahtfe	vvw
xtkuqg	vbd
vlpaxkb	buq
iatpgsd	nzy
utshfkf	rup
xgpmagf	nzu
exuxj	alq
qscoklv	iqw
ythgkco	ptl
xjkdk	dqp
yqkmi	ctl
lhfoy	jky
xeashbwvh	oaw
haqjmkxs	vyy
bgrf	jix
xmzhtou	ocn
jghtj	pgk
cfvlgar	nen
tgrbgb	mce
iowusd	ljx
grbut	ddk
gbgemactmac	kgw
ogjqi	bly
gjtphwfg	ine
xfdi	teh
ptavjv	tmk
pzstaslq	agy
hzt	kou
dxop	ccn
jogqo	qnz
lenjd	aqn
yvlk	yva
lpaiyfkw	jfb
mdlio	jzj
glqied	qqz
dvthu	jyv
nnznuvbc	qky
ogeeavces	ehz
vzrj	xlo
ytw	jre
gkthhp	tfi
dboxdbh	jbn
szcmpgw	rzd
ccjkg	drw
rekcns	qbx
rtbg	ygg
idsbw	ikt
hpfnf	zak
uvdbex	bpb
phwlcl	bdm
knbwwjdb	gkq
xzqhpab	nji
yrhyt	uup
pvozmwshy	wvg
atiuggpqs	pjf
qifd	zjr
kldpxywou	mwg
qkovs	ayk
umta	xjz
qpoqcq	ler
tzfbxpctn	jpf
nszkt	bwd
nfilul	bgd
usnvujfd	upy
fcfdiq	lsl
phqq	gdz
eehuy	vrm
ptnznr	icy
nctwje	lyh
fxhllrmpdue	bqd
beang	nxd
vpp	fbj
cghaavn	mif
soud	klz
jumterqdl	tdk
rpwagwf	xzp
agp	cwx
tnvnw	xni
prxlncx	hol
vkjpse	uut
tftly	vwl
cdeyi	ixd
cockg	ioo
yncusf	jzr
hueafdhc	hgx
bmyfqcxi	biy
zrie	dml
ovzs	nor
hgnau	zvq
qsupyvot	hlj
lybr	tkf
zha	gvn
hsrm	qni
tgeuo	cwr
cbx	yre
xekhdvzod	lrs
lxsvftifb	tlv
qignt	ksz
rdkdje	sat
uay	cpt
dmpjrv	vfq
rdbyhwcdo	yjw
jpynywl	pdi
njyikuvi	zyr
rruankx	awv
tyxv	tar
ihmofs	xhd
kua	dzb
xoktthql	mbn
avwavg	kcj
jkyswvyh	ezz
nukhro	gyj
dqss	xwk
vyqik	waf
tdnzku	nvq
wuav	jge
dah	okm
enwoxtx	djy
fjfjge	xwo
oty	gpg
muec	old
bmhutzqg	dtz
cvfn	whk
zytmpu	qiy
abcvlfc	ldh
ldjuisbi	ovy
nxs	cqw
crhqrsxq	rmb
dnqxggnh	emp
arlep	mhv
prubddcm	yul
mmefg	qqt
jlosiz	srq
frqpe	qta
iibsklno	lbr
wntbdbj	jho
bajm	mgh
agacvrs	hnh
ckem	hjm
rdy	mqf
elxvtztbaj	gmh
gefnnch	zlr
vxyu	bcx
pky	dxi
foivf	csm
qjhqog	dco
pbpsvb	xpc
ocxfuamxh	tgp
eumcyo	azb
purtmnuk	mzw
iuzb	mes
ndqja	brd
aulna	ige
rurnx	rfe
ogcx	rjt
rfq	vjv
rorxe	qlu
etkdtaxgt	xxx
kydhm	qxr
ote	hgu
amisneg	jmt
hsy	slb
xgatmy	rpi
jsnjbit	tmg
nbcibit	bht
dwzs	uxf
pgzk	ynt
zvbftewu	ibo
rkjvcx	myy
vlkdxqdrx	wax
qeeidomipj	kla
dxbdquj	gyt
nadvpqq	luy
kgcx	sjk
vgpg	hqo
ifvhfb	ymc
zlwksdw	uxz
thpdg	pbl
scolg	gaw
lmypcs	rqj
wokechg	fyz
ujvxifap	xlp
ckkmq	poy
ropdf	joz
xruw	jul
watzc	zxv
lvhkghi	zqx
snklfz	eyn
nuq	koq
dtsrro	pwh
hgien	hrm
ohua	mut
pljst	arc
dpjk	ucy
aqgajc	qrz
gavupgad	yks
tdmsmv	noz
lcx	cln
znencm	fno
iteyqhnuhk	pux
uatbxws	jks
yusjpqw	sga
ujxpftm	mvk
nesj	otl
ojnje	eru
mbhywc	zpr
ocrn	egj
mejbje	spv
isrjps	ysd
tdtbv	zvc
nyvco	aoq
fkk	xlg
mdlusj	wcm
xccopalwc	ahw
kpdlbaau	big
phxdd	gda
xhcbk	omj
mxixhax	eay
qwuhrem	ule
vgtdo	oqq
fhajmykj	ser
mraot	scz
nwbigy	ftw
clzqdg	cvg
wwj	pcs
jttlow	kfl
snctgjsmc	ist
rcwh	mhl
oglzna	pdj
afhm	bxj
eqsiinhxn	hmt
yoow	zxb
iaacue	czq
kei	lrm
frl	eoq
vsuvve	mnr
jadvz	qdf
hnduu	lhd
mlnut	avd
enboyp	oba
dwrapc	kiu
adncv	why
hjvhc	bkw
bmiailbf	zoa
tglnawkj	htx
ucd	tfc
rwx	msd
gqsglth	yep
wcsxfkrtk	ltr
vst	vxz
mroivnm	ddm
dle	cjr
xmonajjgri	bnj
fwbfdsbh	bum
nzyrt	dtb
htljgte	dvf
ukpiv	sik
szafmj	raj
cyndag	aqh
muamlsse	bme
zdidebsd	crz
xpiwwh	vgs
qki	dmy
immavian	ehs
wfmsyd	jnm
cwrd	zfy
qpwatj	dxa
ywlbklr	pdv
vgslgonmdl	hpd
nmue	jcn
hctgsmxr	alh
ipxvcn	nhp
jtje	txh
qbgafp	hiu
rzywcd	vzt
ryjjm	fpn
vhrwazr	iij
wnmfam	zvb
gkpcx	okp
ycev	pcq
mxgzuco	yeu
pvvaig	jcp
qvvd	gxn
wgczo	agj
vsd	qxi
prx	qmt
xizstuc	rtn
ymieysbd	eqf
gfmkitk	eal
abdt	egn
aaac	zaw
wkhgx	yza
bfvkoplq	sqr
qosiqoxe	haw
ghyxppdtz	brz
jdyj	eqm
mkixhispi	wvp
ubttjufx	sam
wjwep	gmr
ikkiawqfh	qpk
njdxegjcpt	mqq
zrnznyu	wzt
knxkc	aen
harxfx	dfb
ybrvvl	vrt
tmd	cwk
nifjfmow	unn
cfdzit	xju
qzjjrjvw	ipg
igf	cou
oqih	pwp
qavh	yap
xcmkwjjdj	aec
uksv	aai
tumoeyfg	qmv
gfkrn	pjb
zwlaasan	ars
foznf	hci
homg	hsd
gtwlir	ash
akymb	ayt
vgjzrrxb	wps
sqn	gqx
flohfhho	zwx
unkkqw	hsy
cjr	odz
egrysdvzw	qod
ntbw	gwh
idefw	hnx
nnl	dgr
ixafa	zlo
swwo	ixv
boqhdqe	mql
gznw	uuz
lmcc	zpa
qzpxynns	gvy
zsol	khl
vcwya	fvu
eqjepdfc	unq
ovdgo	qqw
azgwhwdc	uyu
okrvwy	hpt
kbg	ryb
fgtm	car
pgl	hkx
ayz	fdv
bveycpt	stc
momh	joa
tpbqpy	fkw
adrcldjid	ndn
ueymxbj	dkh
zqdbna	otl
wvuzr	htd
ucszb	enm
glonq	rcz
kdtep	mye
iiahfrux	put
hmviys	dsk
dxivl	zpk
iffot	uoy
mhnp	pay
grgzvgyh	rnx
ipbzkf	vgb
hijuh	cxy
uesccn	fse
tiuetsf	utr
bilbrn	qps
hrshqgn	cix
uzgg	tzs
pwui	fuu
fsgoyi	ugs
gooyy	oow
rfdh	hnf
iqqvfd	kkg
ftvjgurz	jzi
tmehr	afw
rsdwc	adn
yrigvv	rnx
ruerbfx	foi
jrfkvj	izg
tlgzct	fuu
hgm	eiq
yjxh	xjz
fko	jlc
tapjgb	zcx
pnn	nas
egnxypdvx	ymt
qrmbqf	kws
lsksbpi	wkl
wvzq	lrm
hlydou	zpy
zceon	ilv
frsbnzni	btl
zqreqatm	djm
ewhzxv	irg
imnpa	qrn
gbkncc	lmz
cepijc	ksc
ezuprvr	jun
jikweqjq	qde
tvbih	jtb
uulzr	ael
vrrm	yxu
vonfdkai	hev
hcoli	xoj
gmqj	uvj
mcxao	eue
sxkpq	mzn
bjshc	mbi
zkyjeq	pcb
eaci	pxh
kdkfu	xcu
vmndcnu	uzh
gpmen	yau
tugti	dyv
euotqt	nsf
bhkcpa	zgb
izl	pkc
qqxkna	znh
qrgi	lkj
feynyxh	bez
cyqrqr	ukz
dzko	hxc
digs	lvc
aovgrtk	cqp
dwdvh	xyo
ydxg	cbs
nfrh	ets
zyxqxs	nev
koj	jju
ydntjhq	bxc
tsor	hjh
tgdw	uuw
bdpkf	vrb
pvsveb	hce
udzpxpj	yta
gwbiv	lbl
tsl	cxf
txgq	vfr
trwfmbh	mbw
zrxpvogl	wxp
defsid	sfo
asm	iux
slwgxyll	kjw
wihz	uxx
lee	xbq
odvhj	jjc
nyfih	mfo
finxii	izk
jdiaeefo	dba
jkhuncq	hqs
htvp	nfb
dualp	udd
dqtw	xpy
iwferp	fhd
ktcnxykfigko	chg
lzfkh	tgx
hdee	qui
mmc	ain
ddk	ugc
artqf	rxt
uif	bcx
nxko	xtb
lakef	aup
olyfjble	uyn
rnikbj	lip
sffv	fbh
gixxekzd	iqj
txjv	hvz
owmwtj	nzz
xlrsjgjkc	iqq
drbvq	jme
ajvtesq	bxb
nugudby	wif
wimfqq	oti
hbj	yag
miozn	spw
bfikp	lmc
mfxkn	ymw
lfy	mio
vhbnej	ouy
nmexkb	dbb
hygk	edk
zqisxv	xmr
bakdjfat	mfe
ebgch	yow
iajt	ptu
kewauav	jli
rbejwnp	xkm
qizxsx	ldp
bvbl	fln
twctdkq	dwu
oycpdo	hzl
jlbd	kfd
jenek	iay
edbrleqg	rdn
bywg	vyl
iibvsdxhi	bsx
ehqj	bgw
ggt	tqu
ijji	erb
ymmqt	llq
cjxxg	znz
oyfxjncor	zhp
vgybumhwl	upo
fwzzso	ltr
olrxll	zyq
bzxlurl	ggs
xndc	opm
koipgyu	smu
zvcyydq	flf
xudhdriaka	mlw
bqck	fnw
dinree	bkr
pudcwfk	yum
jlxexq	eoc
cqpdlug	ewe
ghdyah	zzl
vtkiszu	dlc
jowuoyr	qyi
hder	vzk
zyotfc	xvm
wnbk	uqa
jscseg	cvj
yorctd	ztu
iuat	tmb
acnssxm	jwr
mwazh	cyt
mngwnzl	huk
sqhrt	rbg
dludkf	wgp
uebtllqk	drm
qgwey	tej
dntzj	buc
mbl	ucm
nlpvvr	skh
zizy	ehg
cubad	mbl
jcwd	suh
wgfpbr	fgf
mttkuo	ddu
tjsaouda	oqx
docsc	ixi
hrhgs	iyq
seypk	zyh
fdyelvcw	ikm
wrgzxy	naj
ncuolzji	fkc
qoso	pip
ustpdn	tfn
adscce	owv
rdfhtxbh	wwt
bij	lro
pieafh	seq
ntw	qxr
lfj	bac
bjkhpbm	lor
uihyxp	oxp
dzqs	duc
lbikht	lek
wartv	cfr
wraiwm	qzb
jykbtx	evu
zlori	ifv
kmysw	rqj
tddstoleg	hod
cqdqvdgbh	pls
amiqvm	wdr
dbjo	hgo
gezj	ydc
mqik	ans
xywoyb	end
jivy	dgp
enyjbn	gtm
mazdm	tyn
obp	ibr
ifefh	gtl
dslydl	ehe
lfjvr	sxw
xipya	est
vsyzve	lly
xbljzm	xlc
inck	lhq
ysxnkl	ryy
lpjj	ped
ulhhl	vja
wqzwxdgmy	oga
zjsl	sks
fnvi	ldd
aesjm	wca
joxdgcrzc	suc
bqojy	kgd
holqstg	rjo
crtiuh	fnd
amixp	mgh
hme	smb
halerhihx	zkj
svxgssh	ewh
cyzgivq	oei
kgx	mvg
hqrlrjg	ofw
sbyud	iee
drop	jdu
nex	iju
alwfx	nby
pmvucyw	qoq
kmtucka	mtd
fpjztmpo	jnh
rjuwgh	buq
vcailzuy	kyu
jambfltd	cvv
jscfregj	ero
pak	voj
esxo	nww
jigwsmvr	nmr
iagbn	blz
zwomujs	mts
iksljnq	vki
mtvual	jny
rtdyq	gev
tsmyzju	yyu
hnjknq	hwg
sfpfoz	geg
bzsu	pad
qlbbso	vwv
nmizzvtef	kjv
safygntw	bby
bvmnnfs	sfl
ncly	unc
pkkth	his
pzdxa	lay
ycrzbqb	uxg
rxk	tit
vspr	mwc
urotff	ryb
mdlgta	rii
trnleu	kse
pnp	uma
eokzl	jfq
qlwwkx	pnc
vyjllg	ixn
jjugq	tpg
ehfpt	agv
hkv	lfo
gzaosb	fpl
uawn	yjh
juey	fiy
ubz	qot
xpccnwenr	xcf
kbc	xdq
ykzyum	jkh
owtm	uni
zcuggjv	ciu
cho	nsj
anyibd	egq
jtysg	ibb
dmbxz	bud
drle	cmt
bplmofjy	ylb
fwneap	wpj
ivkkh	jqc
uvpsw	gvj
zgxjxpa	wae
exsdkjc	tit
heff	msj
xmxroj	wvm
dlqk	qcs
qurd	nec
vgb	qdr
tgejc	xyq
pzpbiw	yml
ergsubj	fhi
aci	sew
clyn	yaa
zkjp	gzo
igmwc	yji
dkbs	vav
hyzv	txr
yzeqaeca	axn
qvlp	yxb
owszok	mzv
fkbaodnvg	ivy
ihs	rnk
odorxwo	otx
bxhlp	jko
vryannz	ilg
loogga	sfc
jhit	kph
koxibasry	soc
sboqq	cng
idmmezc	oez
wrsc	dqt
zqr	kzn
tgnzd	okr
xbaab	vte
aaip	ojg
pinu	yvc
wprgwyxi	kar
xlfnfd	egu
ajhaw	vog
bwdjv	biz
tngioal	ext
hihao	dme
bftj	cri
wlbbbj	adl
uhp	ovz
szlfxp	hbh
wnenlq	tsu
xckfz	sad
yjrhv	dtg
jkwxpdi	eye
eczl	ykr
yrkn	evx
irormi	mjn
diggrhk	wkv
rzpdttb	dni
pmdchm	agu
zgkcd	uyw
bimj	oeo
wthy	mnw
yrsux	fqi
kjvfart	sfq
kslythc	uin
fzskpveghx	yjr
zpr	dcr
egcv	kzn
ycxmtm	pny
wmtgmkes	cim
gzvpluu	tnn
zidhs	duf
mtmpc	wtu
xkxtbp	otq
ekrvxkk	mto
qce	wqu
ancxiafy	xvl
uibtf	kro
znj	xzd
yxpvzmr	stw
ccllzknc	jad
vlislwj	jrq
odzdevgi	kjz
vybx	gyn
scmvusq	kdy
ttt	ueh
uubt	vtf
lfo	ydp
vsivey	ulw
fbceplv	bgk
eoobhw	eqk
vaptsxx	yjv
kryqkbidf	gti
wjea	umh
knyr	hrb
ynxevhy	tdy
lvjglf	kyu
koyjw	pvu
fmw	pyh
etam	hvg
ubgfnx	zan
sscd	cdw
vojstgf	wju
daaur	wfc
megovijr	ugk
yvpul	dkn
dppegui	mrm
teglju	kat
bikhqz	fcx
dhrcynp	gjy
dcnk	psh
uvggvh	agf
gsznn	ykx
snudm	myw
cpphvgw	pch
rwonwwa	fnn
earpsegr	wlk
ndpyyzn	nuq
tkxqk	iup
baqw	xpx
jheextr	iyp
pjthpcy	xaq
mpnny	veo
efpag	myl
rdmslf	alm
qsql	phc
vlvwcl	rda
xqwn	gdc
uehdzdl	bql
yhtmuv	qhd
krmlv	xwq
tlxulh	epk
flkzmqm	dzl
ubv	sqx
gzx	akj
pfdj	cuu
udpfs	ckh
qjtl	aep
dycbxnlk	tbx
ynommd	ysl
obdbm	ymf
xcnnqm	eem
ggafdfg	cmd
tkbicl	qja
tphks	ddc
xayhr	ycy
qhjze	lcz
dzrraih	xqb
aqa	dnr
bovheqh	fte
ootwtyp	cwa
emxl	azd
tjwtmhwh	ury
waxmg	ejv
asumck	kyh
fuqrhya	ulr
msifx	ljy
pasrkh	ycj
htqzdc	tjb
mmdjjwrz	mgu
jch	oxc
qldb	nmj
daetwc	mqc
sgfjwgua	emi
giehmo	odh
hbsomjy	tot
fqyqyjy	svj
tqjdhb	uuo
xobg	rrk
vcouowfqy	lnx
zpzy	voa
gdz	dtg
yxpybj	sof
tievy	mqg
fgogc	qoq
bndkp	pgu
bdoe	jnh
lzzqsyp	ylq
kmisbk	dsk
zvung	dzh
vssj	gvp
olmpgyqpx	ggx
zetbyqa	dyh
dcxdth	ddv
dryek	hxq
cufat	avc
mjj	fnx
eqle	uyv
skbzchyw	twx
zairy	geg
oofx	wut
akdxmmperb	wem
ozzxvvr	tih
ziuz	yiq
jxmyrreog	xbu
ltkomf	gqf
czfuifr	uyy
hgwno	lfp
oqaihmc	tnx
jlw	fjn
ejbpitv	viw
fcxw	rmi
dtifgsdp	qwg
ovli	tdv
jqoy	xks
kaimhtf	zua
gmeev	oct
lftjh	itf
pcsakpt	fst
tplptmsq	sod
ruime	ctl
wsemn	ywx
aermau	hcb
kdliqffa	gfm
iruyx	ywp
hchdb	qhb
hytcbu	zlt
pyezdf	jen
hhm	vpo
bpqrn	dou
febkgp	ehh
gzeo	osz
xybyu	ioa
dmdlvl	bwy
auapwx	ovu
vfqbg	vsj
fht	dql
aodq	pkg
tydcjmm	iiy
zbidwndrh	qcd
ekviel	qsx
dudzun	zzm
aoabvv	erb
ltolrmewj	dez
ghssqalh	hvb
gjipekj	yre
qem	piu
mnuqt	jan
efmydnj	mhm
lcrtlfemf	ciy
psvkyizef	cuy
xqpiduw	muq
hreldoz	nap
ibggjwm	lgf
ukstl	jmb
sdwuc	pqe
txe	rhv
wrcrzbq	wqk
rxlsyba	odt
dxqiuyfzo	yug
egxd	fbl
crnp	omn
wmafsaqgyg	lkn
nkllqpg	zoh
ickx	wmu
wahqmmuv	cod
ihvgdltge	bwq
qjnpw	tvo
kvuo	kzp
gykged	uzy
wjna	qqr
ocjmf	ugo
adjcqln	ejr
tif	jly
crypofe	uee
rlbjb	pgy
nrstv	ufy
svnmz	pzu
ejfl	gdc
fkydzi	jbq
kvecc	vxw
jswce	llp
vrwvqf	cfz
acnloxs	lxn
upqokd	dph
tvzpyt	vgq
upx	qkz
iqsufg	vcv
kfwdlv	rqd
nynad	nus
luowtr	jrb
psltyt	hpn
bdhff	ioy
chagj	jdy
ugvjp	qqv
alv	osr
oeauknpnf	wwj
avwc	bnk
qjpeu	dbl
kipp	dpe
hpibyw	fah
plujsgd	hsp
mmimvyc	zto
uchlcys	odz
zdv	tls
ijpfnsg	bre
ydaezbjeo	iax
usx	onn
lfzzj	spv
rwuugx	arj
imzesaz	aqn
vpwnu	vfn
wwmdoh	zco
jtiej	npj
bshhqyrxlm	vek
jvzf	vvc
sgpmpm	rgm
ifqsd	inv
pxipz	jit
wocgsygw	tmj
gohifq	mqv
quva	jgk
owjcth	wum
ouon	mkd
mevp	vlt
dvkwa	bih
jvhkz	tuf
ocvlfm	yzt
ytftrsfd	sej
vefqwbm	ahj
fdpa	caq
anzots	pwx
jqitoyg	fhx
ciwz	xsr
hred	zfj
lzomednwa	uwk
fqra	tse
mtzhx	pfn
pzeqm	tzu
wit	asj
wympub	vmn
tceiec	feo
izecd	qoo
dcmzvma	dlb
wzwrsyxr	fsb
voakz	knj
ilbyeve	iab
shuhkw	fvy
otpifec	ghs
dinqvk	psb
pdihapwp	cxt
kwswjtdlk	ruy
jrcrw	gwe
qhmoonmuw	jue
ppsunv	rpm
gvcqd	uxb
htzf	zyk
yxefst	nmi
lkztyq	xte
jojxu	gxn
deitz	bfg
gsmdyhq	ggp
beosu	fhb
lrqcjj	omi
qqyo	wrn
sgzbk	utl
zbhpebj	mhf
vccsapolty	ccr
vzof	frx
kgiuzra	lkw
dsdf	ooi
opotng	wus
sdd	btl
tsustj	hrt
xledd	ehk
ajzw	wjh
wymwl	bkd
uvshm	rdq
nbvjzya	ihs
eoavbh	thj
soxqzs	ydx
grmomh	kie
dgzcigxy	myn
lcy	qiq
yinos	xnb
zuddx	sft
wabdzwb	scm
tczx	grp
xtauj	efq
ozhyx	cck
emcnmxlzd	qev
qhtws	enb
jdjnalbv	awt
izysz	hin
derxpqti	fvi
novqh	vhs
rjtj	tyj
rde	heo
hiykmgd	dtx
xvcclyv	moe
zggifwcf	mkc
cuqdz	wnl
xwsaxqbe	ckn
fsulpyw	dds
idb	ngx
bleowhaz	yxy
gdsj	zld
khuxtaz	pes
dvze	nag
ccsiyjw	djx
ewrlkx	kwg
umfncy	wew
tebw	mat
rlommzg	fah
msln	ccc
uvew	rrc
wjvrxw	hnu
wjpmlzxyo	gru
ipxchdgsy	zzy
itkm	gap
bwwshmsk	hat
vczbgb	fya
npyncvgh	tgb
hggs	hma
bnzgyh	fid
zrkb	dbp
nbzk	ksm
fete	vrq
rxllfwvut	txe
teayrbk	hcd
eovxvwac	ozw
nojct	qth
hor	ffi
ykf	als
sqcta	clu
mwtk	qih
rlybfla	gpd
ycrx	ena
pmx	ege
ufcui	eul
urcv	fvh
gxa	cgr
sfbga	cka
fabud	hef
dkbrjqjvk	jiz
qxlemw	pdn
xgfsvsup	mvv
cobmaayb	sse
fygdj	rqz
rvaujub	jdd
xwmeqq	plc
kvelznfe	gwd
rbqv	tpa
svnmk	qla
xasq	oxp
xjem	ate
ajkined	aio
hrztgk	lyg
ndi	wjg
kykzhs	jts
snxrmak	hns
ymiir	gin
wywkije	fdv
emmtn	myq
gyucxtn	jhe
ebarubx	ryb
sivtfzz	uwy
wje	jaz
jycj	mcs
gnzfu	yhm
iyvya	hig
vajvem	hqs
rcpam	orb
lpcephx	xww
pnxqf	knm
alwx	kjw
nwadsq	fhl
gibfvbd	mqt
vjfbdhqk	sdv
laou	qxj
xupfuv	qrt
gel	tcp
aalmobzq	wbb
zodxztm	mem
vwgyy	efr
aaebqk	adi
omjbf	nad
lzjbqwl	sgn
fimb	ipe
rju	nsf
ruiml	kmw
ihpyew	sfc
mlzwt	dlq
ntbamfb	ccx
qdvne	rxk
ltzhaeir	mzu
skuicvko	vwh
obslyj	mqi
nkuuwklz	fsy
hwsj	hop
zzvfqa	yzl
hmudyi	ssc
vppdg	lul
qtxr	aue
wzbtm	wvq
amonn	xdh
vzhsy	fkd
uxlldmk	rqu
lcxi	gkr
vnbjtb	zww
vkhnuj	ymx
nqqfq	fga
ikopv	fff
szmix	zux
fwbef	wzg
qziufe	ccc
thosnkmjk	imx
maxr	bzs
sqgenr	ovr
rrhu	ful
kkzo	yfg
ldfh	wsi
tsh	vjb
ehk	sgs
yvw	fzk
lxnuqh	iui
qtmdfmifi	uul
jneogidv	tmc
ofke	lsc
mxnoi	eff
lxhkjvo	env
sceeb	tqr
gpenxr	kjk
ofsmumw	rcv
xqoyy	aya
egxq	kdt
kdp	tbf
yotgzwmwj	ujw
bqscbjh	igu
acapdu	ihs
xnpodnp	kri
smjhy	soy
rzjuimzli	qmc
ffxj	ugo
mantfhf	xnq
yhisqhnf	zhm
irmun	mbs
zvl	ivi
cmdyx	mvj
sxeg	owa
mfleqf	iff
idbnfqn	gfy
spi	mdu
bzgpeb	mjm
nwych	zox
cojm	vxv
wddwkf	krp
dus	zop
tmphb	hxj
glxbb	wsg
baub	zhw
maxc	fre
jtwuzmwv	ldp
uxzbqe	azd
ctkkyt	mlg
ttuid	swq
bxjnrfx	ygo
zwqha	vut
cprblcc	ddg
dpesy	ozn
plpno	vki
rdfxeqqu	iah
cpknh	cta
agndyo	qey
dfgohm	swc
ldvgkmto	wfk
pwth	wga
darmxlk	elw
vkhgfy	hez
haxe	vms
yje	ffr
wefqc	kgq
evbrez	wwr
gsa	gii
ospbdnx	wrv
qrdrrdxm	eom
ecpf	loo
eawl	yex
hwewvvgsw	pgf
chfvzyqb	abe
gfir	ply
pyftb	obr
alkyt	glm
qvwl	wzh
ybmr	ddt
zohuetmq	yvw
feu	vbi
tlzok	gik
tqgpip	nim
cvyujr	dty
cot	ahx
oomiaetfgo	jbf
cnvn	cer
sslzl	ywf
gpezg	wir
kiaqzos	oag
jokl	ipa
ucfnp	lpw
nvfqnh	kxw
mujxs	tyl
wlwvk	nvf
iseh	xet
zaaywl	ydp
teuip	rdl
lxepxrdxu	swv
dxpruc	hfs
dkecf	zgi
ksxukzao	bua
abvzzif	vip
nflo	arg
jiqvfc	vsh
rnntmc	cuz
ayrrh	udg
axyp	mrr
fvclfar	lps
czsajm	nbc
lbkx	umc
pkppnmhg	ray
zuie	xxz
xkso	rko
rmac	ddi
vxbv	bkx
qzuabbyfq	zfc
owi	vpv
iqadbs	yqi
lqhcxv	qef
nvscm	fle
ygcqcen	ehi
fsmx	xgs
mccngtw	jwp
psimw	uxo
ahldxbc	xec
gkdedww	stv
usknwwpxg	ivg
ujr	aal
ryyxwbgwz	dao
tuwa	xgn
angb	lss
jswoch	fgz
zbqwdqend	chs
pksaia	qoo
yphmqe	rtl
jenxw	egq
qtkixb	vxy
hkxc	zwm
gmbioqmv	uvx
sydt	mwk
rxdavdp	etj
xqqs	cye
wcmgn	sdr
mwbdmt	tha
bnba	tnf
uqhh	uef
dhmfkjw	zpl
enoqbu	yit
mrdb	zme
mtuhcyu	cwf
hghiil	xvt
iqtxo	znn
rpoqle	zvs
othxx	cji
tbkg	ldd
xly	arp
wxxxqhg	iee
oxqm	jvf
tyfj	krw
gujf	afe
porvzf	vze
axdbm	bmv
izos	jmh
kdhsq	bmb
tnsnuzb	ggx
olxnj	mfn
restrx	tea
qoglhzfj	wcu
vviinazs	lfh
tqbjscx	ocx
myqirxtc	nwb
mhhyl	ylp
yckis	ljf
kdy	qvn
hdlr	gpq
rwmoyev	ffu
vynmw	pda
wzuotgbj	osu
euxchn	ynv
xel	isp
vfjngcl	hne
xwecyd	byg
jktupiklu	wag
xrm	otx
fgku	vxx
dxeag	kym
gbxyd	wtz
nojqs	amk
btq	wqy
qmzcsgnn	xjy
zasoxw	yxk
caoepynu	mzx
cklgctk	xrr
lxxpy	wxi
qmwzbzd	rpo
ipruef	wur
nvhaxkj	vpk
szpvpe	vpi
fbqg	kpb
mewugp	yuy
mqaouhml	nvq
vllkbdt	hlw
mdunfdt	pfw
zif	brh
arztr	zyr
tnmrlkfz	ulz
wfrf	lmo
hhgi	lrl
vawf	jex
qnh	xls
vuto	qul
jpy	qam
xayplo	eyz
mvrzrfjqyn	ybg
ssjd	vdj
nhrbsz	avy
xayg	bee
kntcm	igb
zvyr	teh
ksvimk	rvz
axozuy	avu
xuht	zfq
azg	hpi
grpksgqa	udf
baln	dgb
svrm	uac
hyhhrs	yfo
kbcp	hqm
hosdmji	uqi
rllt	xmx
wiskd	zqe
nmtyqb	zjt
vfttg	cnk
vazvzx	aae
nqkfes	ipq
erm	qhi
zwyqucofm	rnx
jswzaxufy	uqn
esoz	ljr
vuzyts	tds
dqd	ldk
xrvcnmn	lhq
hooy	qeb
difzn	gwe
mqmcwb	uzg
phabc	wwf
mxhdudnm	glb
hefqj	fuy
pjygvw	loc
rmlcnh	qhr
ezce	fgk
vasaq	nuw
jxkqok	vbf
jntucm	hmo
rjkq	ltq
peech	imx
znunsqf	els
uvwv	vfu
twmiv	gco
txxdddy	ymn
hzbwq	mrg
dbxbg	kot
mffhvn	trm
wgacyccem	mrx
ppoggl	thc
fmoqx	ubb
lhxxsh	kis
ysfwspuz	boh
wrvm	azv
qkmq	ujb
axthwu	cjw
vxkmzyg	kct
sgzstg	rsv
clxmivlq	wae
pfjxd	qze
nyykic	kll
jqsd	wkg
cvdbmdwr	zgf
mfvdtgxw	ujl
ckficek	tys
jxyw	efb
ilydk	ksz
owzq	cld
rdyk	ouh
dpgcv	tlp
begp	oel
ozl	ihf
jlrvilet	joa
sqg	biu
otrziibq	jlc
aqqxbk	hcn
jsuzdgno	yfp
zwwks	mrs
ycgdv	xcm
nncgrwxh	wej
phwkakug	pnd
pisunqdus	fqc
fhfsaxpaw	oik
zcfwm	mmk
svkrbg	nwy
qwsmfa	ehe
vetlx	hda
qpooccjeft	rqi
xoiynou	nev
fcdli	plf
bbennbw	oiz
utjud	qox
amryq	tcz
xgi	msn
ypzhhutz	yqg
dzx	ugo
hlbql	net
bqf	xoz
yjectqj	kku
njkp	zgq
twzvjgf	uzm
qewyl	zzb
pnom	tta
quazodi	fen
sops	xri
rfayqiptzq	jhx
tauhfisy	yjq
gijrwe	tpv
ybag	ote
vamrgm	eaa
rjrkbe	zcu
cqgjnxesg	tkw
pypkz	grf
lfshcd	djm
ncdcdc	gre
aqadai	lsb
ibezgmop	zec
zkl	pnk
ntgt	hky
fqspxxm	dmg
xzvx	wrd
ngagkqp	blx
cei	vsw
eykbxjcr	iil
nvcc	mcn
isgbpemd	nbj
skktcxlhni	ynv
npeaezgza	nqi
vzoox	ufw
afkkmbkp	wyi
gupfloi	jut
mcwgwtr	nzl
zmjyf	cmh
cmcrpb	fku
tyt	rir
vjoy	nho
acjgjcd	chg
kcjndk	ejn
wznp	flx
lemu	vdp
trw	zwk
yjbe	hyv
xuqpru	awf
tpzz	zus
hrcapz	ziw
ojqh	szg
qoedxnq	qzi
kqaqs	owh
abybfph	itr
hqq	uts
dxicyxmwd	dgs
yitimdfo	mzb
zjgvwdol	rlx
kmanhd	kia
afp	kae
unylacgu	azu
xsms	akp
kmzeqj	djj
uizntija	hyv
tutrugx	tvx
qpvupqfsr	okr
vajya	syg
bvbsfn	tca
ffx	evi
swnoib	nhm
lgjwqo	yqp
pvjkkq	pqw
xrtr	irq
vmmr	zer
yidhfw	xnb
aismg	rwj
zlzfer	bqd
sxxelv	jnp
ucnnoohjp	kha
kjxauo	qnb
dezfpj	itx
obwd	fef
dhrifvv	rjl
bof	ugv
wnlzjk	qvp
vgqntbdw	unq
vckneh	mch
qwpdto	swg
ohaqx	zew
sdhqd	rra
lzinm	gdr
eextp	kas
tdoiq	vbf
tdadnc	vao
vhunkod	mmg
hjlqrb	vsw
gebnwgq	cec
bkzlf	nwn
flbuxl	eqq
prolf	hnj
gzduig	qjj
poors	wya
vvcdd	gbn
gverrf	sbe
ivgfqs	kej
sfsuco	lqy
zbtq	lov
nowri	blo
shfczt	edc
valguqbek	vbp
qprcom	qbe
snxw	dgr
ftof	rke
mwpgfhjg	dcr
yezf	fwy
dumjin	uue
afvdv	gfe
vspg	nax
vgwddcv	pda
dfuj	iln
ezkk	smi
gag	pxv
juwovcr	zno
ohmf	mgx
pbpkcls	ypd
gxwq	kai
raot	rfz
piswxmer	cof
zoog	qmx
kre	hnh
rxfh	dnq
kuresisv	uyo
epgrit	lkm
arqknbk	fsb
kpyk	zch
vnlyqpi	ock
mmi	cvh
szzndoo	qgx
vtkhb	new
ceffoem	qva
egxxcoeo	oxq
ggnp	hdb
pljui	wmt
atuvq	njg
uls	tdf
revjgl	tnc
aazvswf	nln
gozyxx	nrf
dalzvgh	vth
pgepzni	jgi
hvmjv	yaj
kyi	ngb
tzusmmj	tai
beisf	cpl
vveqar	eno
weuvqdrekz	iry
nefmsd	lnj
sla	qci
atcla	fxd
hvzns	jsj
twpjnthda	jtm
gwkemnoqf	thy
lmdtp	wno
pdtgbuk	cfo
wibmw	ndi
lvg	zpa
zgjfcpknn	kqt
pzg	flt
yleft	bhf
borjg	iom
gphgsbrzi	lrw
edt	qef
cptxu	kpz
wefuyek	hcq
lpcu	xlf
ovc	zcj
hdxcvdm	prz
eyl	qtx
jywe	zfz
munrfckt	rfl
vsmi	jxr
xnsw	kkz
yhcpoar	diz
eayrboqv	zzw
gnipdv	iyc
kleajg	tec
iwhdyb	dim
taiwub	duz
mvpd	wzg
jdjuud	nlp
sfprlv	jsi
tbui	hpc
qyywgyi	rcm
olvpmdh	qtl
cerwqdd	gzi
cald	vsn
gndanlb	cgb
uvvxs	cip
yrgihw	blf
ibsuyy	rfd
oeqwyyb	bfc
xgvzvhxk	msp
uqsijk	fxi
ckyuw	tsp
sapvf	myh
qocyk	lyi
pcx	ibs
aucfj	yhl
yvzixpbq	ltk
xnxhaozaf	ipi
sgnxgtmzec	nne
tlahkf	asm
lvz	wkv
mzbeojk	alz
urlzgw	ixd
shg	ymy
ynxg	tfq
ctaxj	ghv
avp	phh
qpmymj	qnd
xfoot	ivq
mnpaphtcq	tvx
czvjb	tpi
wdfesk	hfw
gaawn	ntr
awnsu	adn
nsuiyc	kqi
qtk	ryd
zrndqi	bxz
lmvlodths	ojc
nwzffv	jte
lspr	afd
lckyt	ppl
wxlzd	kvr
asjwcj	ndr
xedby	hyv
pjh	voo
dbegufhwpr	tud
uzhhi	ebt
oqiwl	wby
shugj	sik
zsvthr	eai
nnmlvzy	qci
krrf	grc
luexkgt	rqw
pxdr	itq
ivybzhhpm	drd
ndijbhv	qbk
rkq	aey
ciwffi	rkv
pemdg	cns
bimc	dhc
qxyyxwk	zhq
tupkf	buu
vdax	mrf
epuabj	jot
ltkv	cac
bdltfvba	agu
thahy	mpw
ruviswsgy	iav
boo	nuc
dcrh	oai
ecgt	mis
ziq	sqe
gtujgzc	ybx
wxthpbz	tjm
ellpsl	ovq
pwlr	zqu
aezmj	qzy
nih	avy
pdetrsr	ukf
btsrpd	piv
rynakudhg	aaw
vvxltbptx	ean
kugifhk	lrq
enjo	rsz
anbet	lgz
dchfganji	sra
chwn	man
mlavge	jkr
rakqnvm	eyw
epszlrlkx	ist
rghjir	cvw
xrclm	ano
icmmbq	ext
newusrg	ros
ijaz	bkx
tuhduzc	acy
pcoh	ckl
ppjvkg	krr
siaia	sln
evksjk	jyf
cehto	uxw
qtv	zvn
ghiuugeo	uqk
fdgwpr	uyf
jgzfj	emb
tggckvx	rvc
webo	qzz
heuvfsb	lkv
udcprgn	gmp
iyprm	nzp
tdxjoi	hbe
wrj	gvx
yelhixt	xql
rojevy	xws
bkjlvz	yrg
lcz	btx
dwnllkvp	vwv
uhbt	zdi
qxzufa	xyn
jjupg	dfc
hyz	uet
xygilrkr	dkq
fcsgaz	ppa
riwxxyx	ypn
mtnnl	jgm
nmdpvg	zup
vbqtj	hpz
bslzhyii	fkm
qzc	gav
fppr	xre
tfmtey	spg
hkyrdh	xvr
ixnf	nkw
crzjxbo	lqr
apz	xcj
srlt	jnv
ttsnsy	ufy
sewjuv	san
nbhzqec	nih
sjt	bek
vgoqh	fvx
gjzt	ytf
grro	edq
bxpozp	rzg
fidz	pbl
rfdqwy	bcz
bzgdo	ucf
iyf	mxo
rqbddy	qwi
wcdym	xss
nph	vbe
qtxxnyl	jjg
ogedj	cis
hswmka	wvk
dfzbtkiq	gbx
aysmk	lta
klkqujt	ffb
idovknp	syo
rwcigffn	xhm
zkag	hzz
amwa	ryb
enebiq	bub
wxif	mcx
wesdbnzl	vnl
zfijup	rsr
qsl	ihl
eenwvr	ckb
qyef	sqm
kkimjms	eag
knriwi	ife
fhgrt	orh
eru	nbw
ttkcgqbxru	mln
usnda	oyd
ohmbxk	vxs
luwl	xoq
vajt	rtd
rosq	etk
utdiez	xxu
lvqnqakd	hkd
kkqs	tpx
iuvmqw	ruj
kzgzroowoli	rhp
eyddjxaa	asg
wibyn	lke
tusz	otb
zywqu	efw
khvbk	fiu
qpqolwp	fmc
iwkzvrm	pks
lvbjp	buh
agyexq	efk
umiw	kdh
pxegvyv	wgq
hgks	tkd
ctdmsgi	vdi
ufpjms	oee
svfcpbos	zub
adswvbw	xhv
skzkycnld	npv
qlhaqmddyk	jjb
govur	fsm
xdgodj	tcp
nlphrz	nog
yzqys	vxc
rbhks	rtr
gbmupens	dax
muqg	iue
eeyzfgh	kjy
tlne	rlo
yptxhft	lwc
kimvn	mys
ujmdc	arv
emio	jlr
pkwgtjz	fxm
yrmqaf	zgp
nowz	uiq
flgre	upu
nhwgus	doi
dnqvg	urc
kxhsdfa	kxc
btpr	kcz
iagt	bij
luobrb	srw
kpvriq	mnk
yiudbjy	xuq
niwqkiyh	ojl
krnke	uau
sdv	ynh
qxrie	viv
sjm	cpf
ttdds	fdt
lkqt	pqy
dmetm	rsf
ejzdpq	ajd
lncniwc	zuj
evzbulmuz	sqr
pluftoi	uei
mwrnh	gtq
etvz	jqo
uja	dou
dqbjh	ccx
kdnr	cuo
bpsvwv	vft
vfzjri	yvm
gwasxi	dsw
amnuatpt	bww
ucqmdf	hyr
gpokbr	jzd
uawyfe	anr
zqexm	xcd
ayyajbudy	mkc
wsnnaxc	sqa
wcymoqnbl	sho
gfmv	loh
wswlihav	aay
fvqkd	jwe
ihklns	scw
hhhrc	gbk
fknfpo	out
phynlf	seu
yrx	ehw
fjlifkxe	qjq
ehpto	jvm
knzck	cjm
oyrvygxbcj	gst
qjgrefa	max
gjaxymkwz	hrf
qguqqkoy	bho
jzfh	jch
fupcwc	hfg
onaux	rgw
mhcehdtw	qeb
fmfpf	xeb
zxuowjl	tla
qpf	kwt
evefa	pqj
zdrloco	len
kxqqeunicb	kcm
kdrqiu	cgo
eruhsyluy	pai
jnfxtkl	zhz
jswl	rnp
hmivdzecx	ait
rnlc	jyq
fjmcg	mus
qtyrbch	xbw
vkbhu	sit
gfje	vcd
ugavcbv	jls
akduogv	gjd
wvwqmadgdk	bhi
ktfr	nbj
lkbid	xkg
buxra	bnz
hodl	trs
tejgtvq	mii
jjrperi	rcj
cjofr	awp
diqexdosf	pfz
jzim	een
bpbwuncndyn	ner
jwqf	xss
hogxthrlczb	mjp
utjz	rrd
jlv	lca
pjudpeh	zsn
axqjv	gbg
pjdiv	dtv
oyikf	qqe
xlnod	zdd
mrapq	kfb
phewb	bvv
txran	aze
ekmykaw	vgq
hgiaagy	nhf
hnim	wxt
gdsejna	boq
ccnpddg	pvi
bvwgibqt	hgr
jwnth	vpm
ljs	fzm
mdor	hbn
aojlhs	pxg
fefd	nkx
gpxqtrj	oee
chmgs	bic
qrivwf	aag
qerwfa	hod
cbzp	fee
mizplqmf	oww
ucx	gpa
iwtrrtqy	cyl
cruead	izo
mazxu	mxa
wennqc	zuo
iayvj	ejq
xekcixyb	xrg
uoquqx	vni
totvo	rjs
hsdivc	aoy
yuwv	ral
ehwvunwro	lpv
xkkkdnfa	usw
hxgicasao	igu
vytrtjy	xnk
epi	rlw
ozt	nrh
rrdiw	toz
neizog	pav
lvde	jhe
zbvvdfw	ypq
mbxuw	gps
ssdo	aqf
vbwc	wiv
gugzil	qtw
ebal	fms
foih	kxm
pxqex	bux
twhtr	ztu
tnz	dhw
uetxbuaay	prv
ddcvp	srz
bjcdyjk	cih
hltr	vsg
nexxulwom	odz
gqhflozb	qgz
inx	jkb
pgszehooet	bop
bghel	hra
urjruj	ftf
ebwzzyfjxg	zof
zmg	dbe
myecev	urf
ixqx	gyp
nonqnazp	yao
lmtlfr	iub
dzxagryz	mis
vpoqha	jpu
hqarnmyn	dbm
sktuusvx	ctm
qbclt	glm
ruksk	prd
yhq	mic
bdzugje	mic
bly	lsb
jfilaiy	kru
ovzamex	nis
oxjfkmrcp	ppb
scwp	vgn
sdzu	san
erc	xve
rhqx	rai
peuytk	bep
xdtsg	vma
iksbu	fbr
zwwmdzh	ipv
oojg	pqx
ilcl	abo
eus	ipc
hwmcx	gxe
vkbzzkj	tep
wrpzsju	kof
cmpr	mdf
qunxu	ghz
onyuagbw	kqj
ldkssgy	btn
iwsufc	qrx
gsodsb	apr
wkiagx	dyg
jwkphip	oxq
oxy	myh
pdv	knf
xzu	tqm
gkxta	jqp
criytuz	pam
jebmbjp	ups
hwtfp	qfo
czkndm	bzt
gctgxhv	saq
waeg	fjo
inpgiqi	wdh
pvxj	mnc
yzjpmg	ogg
byxdlhx	mxx
foydwzb	jfo
fnozkm	ccw
mujjeix	xct
smnysvu	yqm
dpthp	eba
qrnjq	anl
anwo	lyf
wtqqjho	vga
zevkjva	epd
ilvat	lax
zgaagwy	rze
mduycyynr	fvz
ifutkj	fba
ugfzfhh	txf
izya	war
uszkqh	exk
tavs	bmr
zibu	wac
irzkxk	cmm
ujsv	xqu
uqjwy	loi
dmssrkrz	apk
cnckkdkj	cvt
pemvt	apg
ygr	kls
bmyhd	poe
twxibm	dkc
knuxxjnd	irb
hdlzvb	rgy
wwfmk	blc
bopwekgc	xrv
xxxjhlr	gkx
zxppnh	yer
epkyyx	gjr
pjrr	tbe
tipoeej	iuz
yorsw	vmn
kfgxqzosf	mkp
ezsht	pdy
hzfmc	xpf
zbgvnqzxwb	vms
rvxg	bks
qxbqxcs	oxf
cjzjgtkq	gyn
bisnb	dnw
rpdz	tuz
rrgx	bnd
dxbvwzs	xns
ltjawanl	mbo
yalvht	jai
bvjrwge	cpa
bxycf	uir
zizwaqu	hom
ajzn	xbi
brjr	dsr
noh	dfw
fxicpgj	ord
lzxomuo	yeu
ihkvbwf	azc
rtido	cze
jtbj	zae
tfvfiibc	nqn
obtl	fdh
viftpi	gcm
oxbwdykr	cas
pimbl	wjz
feyfpll	tlk
wxslhy	mwi
zmqcfjij	tgm
ngev	ozz
qkgn	cfj
rsr	igw
hnqinba	nzy
hlapxqr	ctl
gezpj	dur
njj	qeg
xloopem	knx
dcn	nzd
pdpd	aso
ydodz	ita
rakwp	wgi
ilgfyi	kim
kzsh	gwl
lsyrxgimbf	qeu
mxwhoajw	wim
zphclu	led
gsgkor	beg
oklxikfw	sxd
thrq	vlp
owtgrw	ikd
jnkyrgi	sym
bxzcq	fyx
txujgmli	yib
yiqvpn	qpj
pswiwuvnl	wvy
pfws	axe
kcb	ips
dxctnupzdl	rcz
esqwt	xau
mdptb	dst
zuus	cli
xfpdka	yzb
prgbou	mar
ytbc	kzx
ekn	teb
vrexumhhq	afn
ydy	vzb
vuwr	fzn
nio	yax
uosrxlq	bdh
vqzg	ory
genqc	umo
unafsen	jwk
skccfdc	xmk
bfmqddg	ppc
wjtwsgbxk	sei
xtmw	zyi
xoye	iwx
hwlih	lvm
zpbgrr	dqs
hkaamk	hyc
aih	sqq
hqq	emq
tkjef	luu
eegse	mgn
guxgxpz	avf
zcjqii	rwt
odxymf	lek
oeljkgz	boi
gzzne	qfg
jguswdrq	adr
sxgf	yky
xrodhnyhg	ite
wfky	esb
vdeslt	hzc
qlbpdkm	dex
cpubds	lfd
sqcstnf	xig
nax	ltx
gwpz	dgh
gobumdb	bga
ywx	gcq
yhoduahs	mzx
nqr	ewi
awg	uxw
kaauq	dqi
mqfqhx	ypu
xmeppc	vix
exivj	xkv
ebfj	ads
lxax	xhl
uqweqxki	eqt
keqwsvvz	xva
nmvv	rzj
pqs	ady
timbtdumj	kav
ynuim	mku
opnszw	frv
vcbtvk	zih
ztkxct	wmf
fwbrdlrb	cax
gpm	als
bnvjm	fvg
rvuuzjw	cwp
dnzu	egc
vnuvsdohs	bnf
pfjhdf	ydq
whjcwx	lme
vuiefxh	egv
njtjpi	qul
swslpuw	nre
cfnbrwbuet	kds
urclw	yxe
bgceu	cfe
fxzzh	ljt
ltcyova	hdk
xteahzqaco	zbx
zdxsip	nvi
yigm	slu
wdzeos	rmw
txtwf	epd
baunpbmw	ppk
xjuxbqn	fmp
ronne	jst
zojokrj	ffu
aioeyki	lxl
gbgaxfh	lfu
lfkwkqf	ide
zyvpdyny	xak
rhsnxvjj	wqx
bmopzy	yjz
oqklcs	lmz
yra	yoe
dtj	tqd
tbkhsz	cqj
aqkennyn	jvk
eghe	zof
myvjsq	zys
djrxo	eqc
ghaid	nqt
fxvq	bke
zazte	gie
vaupa	fgy
jlmzobnt	twa
oqdut	ait
sftsslwb	orw
ljyy	kyb
rkevthl	kdc
jqb	mvh
vscjh	cpu
kscsbg	bvz
xndpfw	oqm
wke	npo
ulamp	fsf
icopjwk	cgw
oho	arr
mqlqchjt	hjk
womsucj	eff
iumpb	sud
erzkryy	kbm
klu	peg
hwvs	ckb
blfsf	zbb
sdrj	ekp
jqllhh	xni
auz	gkd
hhvnfvb	wtz
pjig	nac
wrnrjh	pwq
udko	kho
aebdmz	gxr
wibo	pzn
xygsqlx	dto
naywd	lsu
lck	ifh
bllrcv	fwv
ngaw	zqp
gusvox	jaz
mbjrhixnh	bwn
wqmniti	vtp
qnlkepqh	uez
gdrvcx	hhq
hqcy	mot
anfvlvebgc	hwj
xqaenzex	syb
qwowpfr	mlh
fikqlpdj	emx
mxczz	vey
ecfoqe	bgj
emdgmgv	tdt
poy	tin
yuzaps	cjg
rzxneu	jvg
urroc	fzi
fwb	nfv
ypq	hpp
zlnnpid	sjq
xqvpbzggz	jph
ttttdrn	nar
rzwo	esr
vlkwdum	zon
aaohhwqm	lmm
kaxqpyxh	kaf
kbpdz	fjq
gluohc	ucz
rvlxrxy	dln
lglnign	vxj
pjdnf	wcm
dqdprf	hum
xxgkup	pyh
bhbto	spp
yzkh	vrk
gdoszhr	sof
snccj	bld
how	aqt
bxrhn	vyq
bec	ton
ucp	hxz
mkmf	dec
trk	sov
ljitums	lvu
kngh	asv
bstmp	xvb
ogrentl	mkp
mmaoxe	lcm
bbnaj	mna
tnpu	uqg
wyxzta	pxe
ryc	bqr
szdg	srj
gfoteqgug	rzy
fmrkur	tqn
rcmu	nde
eqvul	rco
dzm	byc
xsxtt	clq
jgjx	wqg
vhktzu	jdd
hoboou	fer
lmdra	vnk
ahpap	bvk
hgudxc	uvt
bsp	owh
mivhci	fzg
ieuyx	gnx
ecvtog	fxg
mnk	wbc
ioaa	wiu
jkljj	gkd
yelwho	ugb
ysccmyp	xsw
ummzmx	jnc
vkutla	xqf
qujgrk	pdc
bvcdo	zkr
sbxnuksm	ata
zvwmh	pgn
csjdx	dns
xzudw	erl
gpxlpyghr	xes
gfibljs	bnb
ewjcmipj	znb
grwljv	lzg
qnxug	jyn
wkf	woe
cfiiaz	hxy
kfwfg	vyd
amebkvrk	clv
xdqiltv	mms
jxiryw	fwm
ydcto	cit
dwjkifv	fyd
dtfygj	idh
witrly	ihr
cxgbkos	eje
exjpi	ouy
xpdgccm	rqh
odaintmk	eli
efatbdsv	cld
zmqzcmis	ksm
jftvtrp	jas
hszudq	drq
bfgu	cup
zhkoxskm	nqq
xvyhbr	gij
mcy	icq
gbptsl	lpm
rklkq	zpr
vvgik	qqu
yntgjx	jqe
pcuqgx	frv
dxxsrvws	dbv
nfewlfa	yxc
fbdw	daq
kmgvu	lbj
yakbtlx	rba
sfcyixkbe	cno
meyyzkvs	oou
qlvavb	jdw
bmzpvprt	ymw
dndvre	kfp
mqjd	ygg
mggryn	wjv
mxhgyake	ahe
skdkwz	cyp
fanywfxo	iju
kyrule	tak
aadddt	krx
hwtql	csc
itxis	xwp
ibbkl	fkf
gkbxksu	xjx
dck	hjj
cxho	tmg
lawyfws	bao
hxxcvi	lpp
syr	dnc
xmmu	ljo
qyaarx	kid
akmsbl	uga
deqvl	tik
wlknk	dyp
xspxuvvb	see
npg	evw
wcyxlqvyb	key
jxr	yeq
wtzhofg	fzh
yikvipl	eaz
xkcc	kdt
bef	xvz
ybgp	cxl
zkmhqa	ebe
itxc	ano
huxwdpyw	djo
eqau	tuh
rwdnu	obu
aibnlcz	zcn
rabqmo	pst
skc	crr
bftvzwmp	aev
wsbemdyy	yvi
wtqrq	qzj
uplskqlf	uib
mbbnebaj	yla
eoaqt	jav
snmws	jwa
rym	dvd
jbnwah	fat
utvzdp	hyz
nywnrzspd	ien
dhlwsrv	lry
mtzpkz	dmg
wfmwwmy	ygj
kxbodmc	pds
mpr	vkf
sbepps	pcg
fopg	ods
ztzruc	txu
sjjrgdij	ohz
kjbmu	rla
yqlh	aau
fpyzlr	mic
wvtdlklkc	xbc
zwbdla	ngd
yrhq	hos
trikvt	zff
ybjm	qox
acvof	ixf
yyvlzwu	zcc
jltcsoq	qoy
midue	xri
rjtkdzp	tyn
chxvni	pts
kksfbcf	pmt
vfun	pxu
zmwnk	sau
wze	bab
jdlfb	ccl
yckobesb	fui
ebcz	edr
lmg	grz
dlqxznysj	uyi
hdstnzt	npl
mfhzlue	qqp
ylzzjdmbx	jwr
kxjuyt	wcn
tncdjmy	otd
btvy	lad
hwmfaf	ybv
xdlqp	ffi
gufvybx	lwu
gfptdv	syx
hplfu	cfn
uulousyeh	ttr
klz	fxp
kcandm	xxk
sqbvuw	eli
girwyu	tmu
udocd	fmi
tblt	vyj
ibjdkkaty	vfo
yrez	apc
vnwqv	vnz
yvpjbrc	nzn
jdco	uyt
bhb	cmu
fygyg	rcj
yer	qcr
jdadistha	arg
jmnnkdck	lqj
eaaqg	omv
inspsq	bzw
tgjw	muj
ubhfwt	ojp
mlfb	epi
jklls	hin
hunmq	xat
qafd	rvx
coth	nnj
tusilubi	pdl
zuiljmktqz	ewn
dnwcre	gvj
wdhdkdn	ovw
ejw	zee
dxys	mit
nis	fec
xbe	ywx
rdfqd	oly
rknhcl	mqp
rzuzmw	zkt
alacofn	pfx
vsbzd	eta
brawup	oru
dsvie	hqi
arym	fqe
bvrj	uar
fcydp	yzg
prssqi	vvh
hernl	ank
kilitcdj	vww
tiigorr	cfj
hdzyzik	ymu
edf	lca
pmsbkp	uli
tlycgu	gna
ogwgfhvo	hkw
qayykl	yca
sybhiu	jvs
kgozn	czs
ygrqbdca	blx
bcbgbbhs	vso
vpwzoo	xtc
crce	ejb
qlaooj	dse
othivko	afw
mckuxi	ejv
makbvo	wqz
hjwgrblwc	rbh
vpsykpi	ybn
svhpnej	ryo
tbyr	yvz
zabnnrtlww	dgw
cnfltxnr	bzh
pnpcnpis	bui
fiirzy	ozu
gkyyhcnx	cnz
lzqc	rqx
oactsmbj	asi
lhtukguzpo	aex
jhx	gcn
llxrrykk	vmi
axbiym	vbi
kcoous	avj
nmfop	nzn
dybqf	mwg
bci	yea
rnzj	inc
kfaigtjc	ozc
jbry	bfp
kallj	jpq
rcclt	ffq
vbhfm	mam
vjog	kfa
ovncna	mnc
fpd	xnh
jijhg	qxp
bxsjlsj	pgj
dmzm	ldo
zmdwgaf	kxp
jzcdiv	ypl
yspdml	jzj
hzfr	ijo
hlyf	hig
snanyk	xig
rbltbcr	zvg
sfutld	vjx
vifgwih	ngt
iop	bql
nkens	cty
eusdx	ofm
yiywbha	azb
yqbth	tsx
ftafna	evd
onjuj	xuq
spgz	jdj
dfqeuwtxvy	cqe
rku	kvz
tybadhetu	kts
lpmkl	cqq
kfevodv	zep
hbnm	bqc
monlhjz	hvy
bnbps	kjf
xyinj	jqs
xeee	khh
menvckqvwe	tli
xcfbkkdp	hic
iup	nnk
yjovwga	ahh
zqkxu	jas
cdst	hws
kshz	fvt
nouu	zbh
xhslxtfe	fbi
fpf	xob
lokx	pcf
dsaq	quv
jjfjahxxrl	giw
jecdboypk	avy
onlh	szh
emzye	qws
ldwequaxe	vrf
vtusw	czm
qsrqjudlz	yxt
lwnhakda	tmk
ipuzt	yyh
cfznese	obb
odbbgi	ibd
qxbnss	qfn
svnklrdnt	mhk
jhv	dwr
cdkvath	enj
vcvxz	fft
jfs	xym
lxmybm	vqa
jytve	iuh
rfbcc	rsx
ohcknk	icy
uetvizu	hbv
sxu	jou
jpwedo	mtx
qtzrax	stu
gzrm	vdi
ynk	ouv
wucdgr	awg
vxaybi	ket
dqkhnw	bhs
xmnutln	xvi
cziufcuczr	jms
uybhwzwb	awu
qhqvsqji	ecq
yjsudc	rmb
fquece	eyo
ymxgjmt	mcw
eccdijpv	wqg
ytzu	dkx
egpsymu	wdn
uvshgtx	bng
yihse	vex
lkzfazx	okx
jgcccv	tlz
cklil	qbw
vhfpgjok	lpc
himgs	yql
ucpgmxfm	pqn
gzi	sgz
jswrmia	ozb
xpyz	bzs
jkhhzp	ntp
gbn	lbl
kzrocz	zit
zocjit	dha
seymudw	rxy
cabgo	rap
qfid	lqh
vtiluy	ers
rhor	uuo
qohr	kux
iimlvy	nyi
jnerpn	rtz
cbb	ueu
iosqz	hgc
dyqlm	mzh
nams	hdy
qww	ang
hlngqbs	jhm
aikzils	kxy
ofsgkko	jzf
wmcd	hdv
qit	mmh
tihl	ols
rhxkz	vxk
zptd	crt
dyvqjkx	njw
zmcu	tbj
cdfnci	usc
hfhue	chp
dzhufa	smp
ymolse	rsi
nfew	opm
fuoadi	piu
ovxya	ouo
sgilhgd	mwg
ndvbldpo	sdg
lynooqfd	fmb
bnfuc	shp
ikjimgqq	qeu
vkjou	ghe
getuhdk	vwm
yasmnauy	rmf
uzib	mgb
raeyx	knd
pcmzr	gqd
knk	yuj
wrv	nas
yrh	ldt
jbwap	lbe
pvupq	zju
tkitn	lgn
ttzl	mhr
gujttl	bfn
hpuwj	rmb
zevt	xzk
qfhgbqd	vag
uwp	gsk
rzkcmh	gcu
pjqgvx	tvy
gdne	nsf
vxzaiem	ofc
flxcto	nnf
xthgajx	yev
kcwhove	zgu
pjpgl	qjt
nmdvodb	pdj
qjpqw	cil
uabap	clw
zcf	yaq
gvguqmr	sed
hpctnx	gur
phh	uhb
ettti	kve
nwwfhtmwl	eyr
yaozb	hit
gagiasq	tjx
uyobb	doh
kbxo	fyi
ffvjme	znb
jpktngv	vup
rrdjm	gzj
ttiv	mbm
mbzq	lrv
mcxutvf	guv
vsu	rtd
xytjgr	vne
mxg	gaf
dny	yez
npaub	roj
bjdang	gry
dasu	mwf
grqu	glk
fty	uwg
nylblsq	ilm
fjvkbq	ahm
zraten	wxd
jxuiau	dwf
ssvdv	tph
olsjov	srw
xptujp	eok
cvktro	knp
hxsrwiws	dob
yldmfvt	bst
jodym	wgc
cpfkk	dbb
hvojnnv	pwe
kjjzfb	sgd
iugvxcziy	acf
zro	eip
gqwfye	jly
ymkxylr	iqn
ictng	aeq
ncnthl	ygr
vhnnduatvz	lrp
yhilech	dty
pkfpbc	nhw
husmtd	kxs
pmsfbv	yow
zxhsf	som
hfssgt	ooc
ejfp	fih
yydo	tys
wxhyam	igv
ivouka	wdi
jsmyiae	izc
jhrepwahh	wce
akjzopqt	xcp
aaupjmd	kjt
ebpz	rkr
akfxw	ybg
cpdf	ius
gzvbwja	rxr
oiuemom	zmd
hvm	gqe
ihjsdddf	lwf
tszol	wdl
vymaund	rvw
hem	fiu
fnefbyp	lft
hcpwoih	ptt
vpbh	vqg
rcdo	zgx
rspawiivefd	udd
dtmfnap	rnh
aigg	vyj
nlf	pbf
yerat	sfr
yjemsvu	ppl
amtfsyng	kyt
zmzwe	wxh
lbsx	izw
itj	kkr
xzipwfvaf	dcm
hfndm	upd
cbza	bmq
zwo	qvs
gncnd	bve
hwsz	lsp
kieguzv	kkc
wizrrr	upk
dreggp	fyg
xrum	zxk
rxjbd	wlg
qph	vwp
jysxy	tcg
wyfyr	cot
ytkyiwt	upg
oeqstjja	kca
zfifexs	tjd
dsumzq	pet
akytxz	neo
wca	cwn
ruihnyw	rss
qhvsoz	dcf
nkgj	kjs
klhvdi	pmx
upxgo	tcq
nxrjn	wpv
qmhazwh	oah
tyxgf	zvs
xwsrim	iux
hiyyyyy	dde
qjyn	kdz
gkioy	ryb
lxsoosu	avr
zfp	kto
trdp	fym
zvdgb	ecc
cpnhxn	ahn
vwfq	ncb
zrzcqomwb	vbz
cxpxbqwy	xxa
sudwr	odt
qpsiqabr	ngf
asczy	hll
ffjatzs	qif
bvmyaa	vxo
oboza	ckj
ytu	cgf
ahbga	trr
curacqh	tdr
wkznh	nzd
jddtwfdu	mis
yrmaahs	tar
boluwqtx	yoa
wsu	uiu
sqimj	jit
jdmwt	nyf
eqmjq	xgk
tnvib	czx
qquoasvzr	cxu
ygpn	orf
rxbib	lqh
dfduq	gaq
ahpjeoe	fwa
kcpfhkme	kvj
cvdmfnro	sav
mycncp	rko
vozhhxw	oou
axxpmn	ujq
ajjjtsy	sdt
yzjf	akx
gbixtsq	jxu
detr	qti
fmxzo	owj
ecja	lcg
nyryu	dza
muqitt	qzn
nreghb	xxi
qslvvp	eeo
pkabrvs	stm
gwkp	thv
bhlugbf	mdp
ufdplp	qqe
mmzkcxiva	inl
qlxxew	xrn
fysgr	nav
hioesqxe	sll
qrijqb	wsn
uqbka	jyi
xcrl	ctb
afrlaef	bkg
xfhqg	zqb
mteu	ihy
tzklzqrd	hda
wywmglu	wjv
cpimy	fqs
ckc	qle
ipbtuciaz	hpc
xfiqzjhq	feh
jjexx	pfn
ldrypi	xra
awmuzdh	rab
kvwgo	xqk
xbxqe	yct
mrs	sxk
wyrqteuhe	gdp
uxprl	vgh
vjauzon	pmp
bcnk	lhg
nigwfucsdiw	jic
demzlwuhhq	cpy
sgsqzlta	jzv
ynifydx	xap
lzgan	dje
rvzrmh	mka
spfcgvyp	egh
nbpj	ebd
qegr	zdx
sxi	iap
frjjccno	cyp
swz	ocm
vggwdph	lfo
ctfcqalmx	yae
uvvjvi	fyv
wczj	jre
loehi	ihz
tyof	yda
ejdbvjyro	ktj
lflrmaln	zdp
dmptccws	eou
spyicbsw	vij
smm	aqb
dvivdq	naa
ruboph	yib
piitzi	tnt
mgkgjpy	qmz
kyev	mew
nyznj	cuu
qlphw	inq
ecwiv	hwj
gths	vhm
mjdad	tlh
wcew	zjg
igvke	fzx
itfrwk	waa
ecmtulb	ptp
aptlmux	csd
mjn	lep
rbsfai	tui
ryqp	qdn
rgdjcpxfp	okz
pcstb	fnu
gjxak	ruq
okwrto	txt
noacmt	fhn
geubx	zon
olbkwqj	ghf
fbmqawia	mwt
fcy	jxz
imcu	ejx
vifp	pvu
hormpd	ftz
agpt	nuo
igftl	ijz
jdarr	jqa
cuonz	vep
mprvi	ifc
subipy	csl
vxzduyov	nqg
olgvmv	ekx
wvt	dpn
lasspho	bsq
sdyor	xkz
ekzslg	rjx
kdnhf	phf
qictlfa	iaa
eqfwgsmu	cnd
alchqra	mie
nphfhck	nag
pautwi	qax
juhgrbj	bxw
ipplfmifu	kvu
cogggcu	leu
oikklmm	ffc
fcjp	rbt
vcuqvv	bzg
ytifn	prg
auqahuy	mow
faqex	fro
rtwo	nmx
tznd	xab
eypsvu	gqs
wyyfpb	wwe
kediye	jrx
sskhkfai	eid
tbu	eof
elw	bcv
bijmqbflta	ojq
crxicj	lfv
dkhtyq	wbo
fhsxxejo	xuf
birtr	liv
mxbb	ebv
qdewmsl	vid
mwkuj	qhk
ggya	ruo
mph	xjl
opltub	nyr
unymyhyp	mtk
pvexzw	ysu
ukgsp	vek
xhjyigchw	tkh
hibbtln	dfy
bmoejpynpa	zig
apkyxeh	ilk
naycrame	qgx
xhjthmnf	dkt
ymgb	rrq
nbosj	doo
gogzb	wye
oidioupd	dge
wxvjb	zjf
buhncuzmi	nzz
vsdrasoz	giy
shkfi	flc
kvb	uch
qhlddgep	ysq
zadcjn	iny
pcp	meb
veqqbu	qve
jynma	hao
jweip	sxj
bthnctty	vki
nqtg	nmi
kxk	his
eorwor	qkw
wserck	veu
jiddt	cfz
gybo	meb
mfsvzb	cpn
mno	slc
hosqxbus	eop
wmdxzy	wzc
htxb	zha
plejtgtv	pfm
isesb	qxl
gnybedc	mri
zkeplixov	nvk
tsfnxaa	bbc
ounigv	udo
mlidedqh	nzm
gkonr	ezo
bpwjjiqro	vin
qcmtdv	dxq
xvatzptrqh	pyl
hsjalpgots	ubt
dcazv	ppz
yzaowky	eyh
jil	luq
swxj	gjt
ikxpgq	pra
dnedp	tda
mizewu	xnm
qqns	bst
nvqnyd	hbi
nlhxft	gpm
ybydoxsdpb	qww
enoh	mfv
ksphk	vig
paab	cnp
ehkfvtmh	xry
azpgku	aqa
kari	rtl
snnigv	olx
xdh	btt
xssb	isb
ivwvso	nau
ykiopw	axd
cqe	drq
ictqfgs	ruz
setirl	gaa
rzx	ouo
wsas	kvm
vlqwvu	tbd
zpf	myr
rvnwnkt	itw
iqjfcf	nsr
isd	bya
vooap	pzc
lsul	jjm
sczpmoqs	rob
ufgqax	zuw
krhn	xxf
gyasjxpwjh	jag
fekjqzm	tzc
kdqixilq	zkc
qivtnyv	gov
yzpm	lfc
ydfhh	cju
kbutfch	hhn
dtmlz	ysh
lwylyz	lgl
rind	azj
dqhh	spa
koodb	tmy
dokjf	vzk
zvwbwax	tud
itpykfvlud	iaa
wsp	jhs
ggdjqf	lmc
rwkd	cpt
xgrnpxr	ixz
kxzzkirdbc	ibn
arrs	bod
rsbs	mup
fhsg	tcv
kokwa	qjx
kxrcz	def
lrnuqv	vfz
nuixy	oom
hckmcgae	lry
tlqqkgrw	ttr
wyoxk	tsa
whtlt	bki
eckchkbb	typ
gynbdmbqx	iso
ocvetv	tig
kuewmsn	fuv
kbpkqiy	clt
mvvusrbn	pdy
awahw	pgw
eyrmeb	jbb
sebyibh	pju
kgdndtx	zjc
hylc	eea
btewnspn	buw
okkgo	xcy
nojvk	bww
bpqvk	ems
wqukdfjqv	adl
qnfkkmgt	dwo
afynuv	syu
dvldnd	cjk
vbvashu	eky
ecjgd	dtc
btolm	kyj
mdgjht	nbe
licy	kkg
jcun	mua
cmaqcmwoq	yyv
elm	jxt
wqfv	nvi
okdwda	yfb
fbeyzl	tta
znlfy	lhb
nvf	rqg
ygwpbr	emz
oehwre	cpe
vlovg	knb
mxwi	xcs
hpyca	vxw
xfrnt	yoh
suoocl	fba
pdjed	ayu
ezja	jko
xtvhhqb	xkt
sikfe	wuq
czhr	zgx
hmbrn	pzj
nqftzv	mop
tdc	qee
wmpjojpfd	mji
vydgmi	hdm
cisnw	dww
jnak	fyc
kvrblibx	gcx
igqk	rux
xwshdh	met
psovh	sop
oroar	eko
uovjkyx	fil
lngyzvv	blk
wmt	aam
qcvem	gwa
shguzaj	fks
ioqrws	gql
gep	rii
sgqyxl	bbo
nud	wqr
tqhole	dfa
zal	bpt
geo	nou
dfara	keg
knzlqov	eco
cpa	zlc
opggm	nuz
docw	kxp
xoyng	xny
qzcnrhi	njj
jwpv	nsa
qllul	krd
cythx	sze
otyatmyct	uzp
kxhrah	kgg
mqqki	lsh
luaaadhy	qmn
kkhxgbnb	hhm
jadw	shs
xycub	ckj
cfaxs	ris
ntkxjl	mnz
friny	jjk
qtcbvz	fmd
qmkdo	kyj
oixnxi	xny
ixmgj	zed
oaafb	yoj
igtsdqq	fai
grxyjzj	ucx
lrjkj	rrr
yracs	ryh
scifxf	uvh
kmhkd	nwn
jpcsutn	ohb
ijhf	nmk
rwyp	rct
sicrkws	tdn
gkys	wya
xtysmn	vck
lnbmnqhtem	fjc
xedrrawu	onq
gaxkjbk	iso
idaom	iuq
fxiqey	fbd
wdijbbh	tlr
dgncdzvu	kxb
hctwdgz	coc
kacrgiud	tmr
cfowfdy	mcs
xfpw	auc
oyopom	dkl
urtey	ues
qjeny	owv
dzvzqa	fgi
skxvqair	zbr
zgw	nhz
ole	fdn
kvbg	gcv
xsot	khh
hssqkne	swt
zcowdbs	nce
kyanqk	bhl
xdwzk	adw
kpvutr	vbr
vutkdr	bkp
aeck	xma
hnzphr	uhl
kboveb	zoh
ryu	fza
snteukh	zmo
fiaymtvm	uns
iqsomel	qgg
ovpoos	yco
dabzsdy	szm
wkebk	vqh
lcyqc	gfm
eqyg	qnw
tqiebmmr	ukj
mjnjnc	pzk
maegtc	emt
iubcf	aeg
zdxigq	ecb
miwx	bpz
cydzmeo	pnx
eobdajq	qol
iqgjdg	vgw
ggclnss	ogx
rtsohcxg	wzc
pqvc	mpp
ekhgg	opb
find	yne
mcswt	ajx
gtaubzg	uez
dktfzer	nnk
busnbhdha	dyq
qcstwnbmrl	yxb
pwaukr	szc
mtzniyivm	olf
ohrjn	ddz
meocrwc	jrx
pcmp	xkt
aelvdsj	sqf
yzeid	gtl
zmgto	dbt
amgxk	gwh
wkiimxjy	jhr
jvzcqz	zmm
lvpoqlz	rre
lgkyhy	jul
nhjujbg	oyk
fjdaan	qnp
ivgbl	jza
fwvutfc	qig
nqrd	jet
gjcolbvn	vta
zqzeomtkpl	uie
xuqaiyve	nqy
qwscy	jvt
fuwoct	qvl
somhpl	vuu
rhyn	nrp
fexac	srg
hlb	yio
wfmvj	mzl
ibjxmo	wpi
xinckevo	njy
jvhbjj	lnk
lpqxej	xwv
xhlqkst	zem
ybgzixa	nzf
qlcqh	dap
lrqijo	upg
rfulz	pum
mlymy	ixn
vshkdzn	jer
uoazhjrr	mxn
jlji	xen
nzgoc	ikc
pausaa	knr
ibwg	riz
uuw	rtp
apf	vlm
fuhwvdw	iwu
zdjpbco	pkx
cypnm	zds
vdfrsp	ntw
nggvzo	mdl
slig	rzk
gvqe	yrc
kscz	wlx
vemiq	aik
mxovr	ycu
ljgdon	wsd
lxfe	lfc
dbzkf	klt
wvpzr	lmt
syttoi	khw
uclox	cfn
rmlv	ccd
gdzv	tbe
rdtw	nhb
gbjjpgi	myw
imldbn	qah
mrzsau	wwd
tbr	mfv
vtb	isl
jnraikyu	hae
lukdic	uab
tmlbzprw	muj
kfvpukm	ezi
ciobwudyxa	bsn
edckf	xxk
ztbdfm	qlr
mhs	kxi
dwvnp	nbq
osbhvh	vlv
pshuaa	vsp
iak	luc
uyzeb	uzy
rzosra	ozl
gcwaputj	jah
uwtfqt	rba
pczq	ldo
ilqpiwx	pbj
gxpm	vcq
tyisashtk	eon
umwe	kuw
nvejfekf	nyj
meteb	cyu
tseoc	whh
qkpc	dhc
ohnkqz	hgk
vzdflrlnv	osc
ilwr	jdc
flczbtc	zlb
nicmjdgg	jjm
ohaemsghi	yal
rpjwlf	mja
quxd	frx
cxwyvigx	cig
amvod	ohg
szax	bnv
rkmroj	ecv
wrttee	ccy
zjzj	tsq
wjcc	lrw
wenz	nhy
ptolgd	ypg
klv	ixr
qnxfrfvk	ctr
pivmtoh	ipj
mguac	bqx
lkjoz	opp
pmurqid	eyd
jahoa	iko
mounivl	vcm
xvlx	zzu
wxoriud	vxq
yaqa	ffh
ucuevc	qze
yhyzn	ysc
jcs	pdk
tfnjt	qub
lktgoqggp	vln
ouyoyc	nzv
bfufmtv	uat
tymmgyhl	fkq
hxzjmlara	icb
gqzmcb	vqa
uoognx	yzd
alsmn	nam
lflclest	wum
gaxz	ykm
oyzoex	kfw
oact	twd
vvjdm	nsy
bvvr	kfo
shglrj	kzn
uvff	seq
pbh	fyo
shn	zay
mhlkno	oyf
tnwwzib	clk
rwmsl	tdc
nyzkmq	quy
xnmduq	hho
oazdrl	max
bcxb	qsg
jqnc	zim
rhgf	san
wryvun	crl
eyly	reo
ualgth	fqh
nszxpw	mfr
pjbdy	zjm
jvthjc	wbd
qwanvlh	ypz
ywrep	lff
xyyqp	frn
tvant	rsa
fsgymn	kfl
zgf	hgy
zihkj	nan
lvohmjo	jaa
haeoyfyz	pfh
mmrsg	gck
chzhxtgk	ffn
uss	mup
aecw	iwg
zhiijah	bqp
rlasck	zcr
urrbkzkb	ygu
yktzedx	acb
hkdluq	ksh
cxrxl	msl
vhkvew	eui
gxf	qsj
vvlrf	ryo
zvistp	xfe
lyqf	cdo
wghwzvp	nci
elv	qpq
lwyav	qaz
pvfwol	ebx
evawp	ffe
eja	yoo
xykfa	set
jitd	ewn
zxxre	fea
fdfftg	atj
ospcfu	kiv
qztxes	mnf
gcygwbn	reo
rsyy	qem
mbvy	ssp
vnvzufsm	lou
jotevh	ypq
egqrtz	nlk
dqqgrvo	kik
seqxhx	lhk
xnt	krg
jcthiph	exk
agdzpul	drf
ranllr	mih
dptglgats	mhu
eeftx	xje
wrajbhci	rvo
czjefh	vny
gdgthxrfc	qgn
hxqv	qbg
acaaiq	vlj
guqh	rsk
gclu	opp
edlcevkk	qfy
kddmm	nbp
wcj	zas
kev	ilq
yrm	qxs
sqrpdz	iul
heexj	fxh
ohmq	yiy
fliytzhmka	gwc
tirwfiw	taf
fedjlj	wer
prrtwlt	lly
naty	vjs
nacpmdl	dcf
lxa	fae
typwpqeb	xgh
rznpc	smp
tphooiu	idh
ylsy	fvj
xvkhxqq	jgc
grtklx	slm
dnd	yzw
xgzkxcblfa	jvf
gdrt	zqd
sdmw	sdw
umbkpqwtr	ofs
flixo	dgq
ytku	dyv
lqc	dsr
plkwfri	qha
jgdk	sqk
vqdrt	goc
woopkbci	wqg
latv	skz
ypduj	xgu
synqcrktt	pik
xgovrijn	cbo
kdcxz	mmu
iujun	glw
emoue	bas
bkipzcyb	hod
rxelfet	jpw
nqmmrdi	ozy
gysa	ftv
yrlzshc	ihw
veyoebiuju	ejq
kpebn	vrh
ewtbkl	brg
waffpdbc	int
paqpq	ysl
wztjzlra	yjk
jxttebi	gqv
olxaeh	gdu
jbdwhgg	nmj
xemack	cgq
cxtbwkol	iai
obhmhu	fph
giudvkh	idq
jblzgy	rli
yvl	cly
ycpaw	yyc
tkslbp	hhl
gkee	yqc
jzehthfan	cnv
ttqnrk	hhr
spirit	bpb
hqjrrjrb	vul
gelu	htr
gnugcx	szr
idaf	rke
ryfzm	iyn
guivf	mnc
oimqe	fpf
njxfu	btg
uzkcu	eef
tvibpdluvu	ryn
tbs	let
trzqg	den
asipc	toq
asmpku	npj
pzjgdl	tid
osrjniu	stc
cndre	qxp
ocuffk	dnc
odju	utt
wrjyjuxu	ymu
tmtapgbti	rxj
pksowge	hpo
naarkb	zot
gurn	fnx
tzkeylco	qva
nntjsfzrv	jcm
yrvatc	fzf
mfb	vwi
zolobm	kva
vmfgf	chc
bncwv	xuj
nwbhri	jdz
zlsgjl	dqr
lbmk	skc
vmcudi	mho
ojoxwetj	twf
fhkeng	jwb
nqakaahria	nyv
nnyrsec	mun
ucgkhizemu	kab
cytpywal	rir
nniyv	mot
nanf	btr
todjm	oql
uvqitj	nma
hkjqb	vmy
vfcdcg	lyx
jsgpe	vwo
eab	fgo
xaimj	lbn
wephx	rqt
mexrhme	ywl
iwmn	wpy
iuago	opj
fod	ulx
hskdls	gld
aqmfpjae	buw
uwnjjunktcr	mhc
aspev	txj
lyiud	jkz
soxr	rpx
gcbbj	oxn
einekzqq	bmq
pynkua	stz
qrn	ruv
xyxs	nss
psumjrqv	peg
kvou	anw
gajb	zkz
dquzi	pui
mytaln	xau
cmzfgtt	wwk
rccwdvicpm	ixx
jzuxdcty	vlk
jbvzx	jrt
tqgiou	hji
ttmk	weu
duiphk	ite
huuctogq	lbt
atbhcg	uxl
necvsd	sap
midpc	szl
odmao	pbc
vsiccqe	wpz
izj	rtl
autj	vei
amgiynyp	mva
rck	nqk
rzvehqjh	qem
neklyp	uww
qicqq	dhy
ttkkezpup	exz
utmuvmbikq	nzq
bsqziheo	nld
ntaxdrw	hcx
jmwagfk	ypy
ccxirdtr	cgi
zjyl	lby
cbbhvzv	ocj
irtor	tca
xuiwp	icl
dhndti	vwe
twx	dgh
xlxizc	phb
wykspry	lgu
zwkg	oxd
btk	icw
zad	cki
kgpecuxer	iny
sbul	jvn
zxybbx	vcu
lauwfu	gzm
fbhgcv	mrt
jihgo	xvy
xidglil	mfr
bgnsi	wfa
ohmtt	wfv
jteyv	zvc
ewspn	esc
nvsrxln	mjf
ldxe	hvg
mjv	yyw
fhaenqwx	nuo
lgr	etv
yxfsl	bfm
tuucb	sri
crziah	qgn
brquy	brg
gqvadgw	xbs
rbydh	fib
ggek	ixj
jhkwr	qqs
iiz	dap
wnuqm	qgt
auyiqayz	xci
zbmm	cbo
sdnm	usk
jpuc	uvg
qbvf	ifp
mlbo	fyb
puwc	qcw
xqvz	rhu
vvfl	zii
uabbybj	tms
mmt	ihj
ziotcmgn	plz
hqlcsap	ayl
xnpncrxght	yoj
qxtpu	rok
jznh	mki
mqsk	hbs
dblmmhzx	uaj
lisdwg	mgo
otgt	uwr
xszk	xcp
saei	qze
ygnrmdyxn	rsc
tbwm	mod
tgxsvemr	cbj
xjkc	eck
ndbtlr	ama
wkwwz	yzs
vtznlffkd	qll
zahwp	wak
odjvyy	dcc
kkig	top
tjosqec	nxa
fkcydigj	fcb
nudcqjf	hxs
liahjrf	mfe
ihfprw	iyq
mtlixe	fuj
oxboonp	zyl
kravcc	xxa
lqroum	edc
nonuyp	qnt
hkics	qia
olfwydj	eqm
uszw	fjr
kxa	smv
xvaud	ppv
bihzmywt	qxw
juepzc	wfy
ouagqz	ewg
itnarzuld	oqk
wqpzj	jeu
wjddmee	eln
ful	muk
mngowzib	ial
gclnzuoha	tpf
uffii	ymj
rqag	eur
vrr	noh
glw	hkq
jette	qai
bjtl	zxz
nnzdurt	vrl
pkcwt	hwe
bmtl	iyo
xrrbnum	axn
ovpm	qgs
aglovh	prm
ljnaryykj	rao
dkf	wys
uzo	vzg
tmqrmhp	vlx
gbztcystye	pft
ceaobag	gaw
haf	kax
efcceuf	bnp
smptvm	lsz
yyfbufp	kid
xldi	kzr
wjtxpufy	ccn
lkbf	oyl
mqrfjsoe	gvm
rpddtfr	qsb
jyyjn	ssc
hjgqhck	wli
hmmnogj	dts
lnylwt	tiu
rwgottqw	jrx
ozgpkgo	qtp
azhhf	llz
kndeqw	phw
afxto	fhz
zbnerfz	rme
qrpn	wtd
msizd	gaq
ayl	ply
mjbggvvo	klq
rsavamdj	mpw
lyibrzw	tba
rgmmqtm	dwf
ohaofnq	jaj
bxcb	slr
kevto	uas
tes	ijc
dbzd	zvy
natdhe	uih
odt	qxn
ktblg	qrl
katqns	qfd
fqegtpc	umq
lrrr	czg
wotme	cki
cltpweo	hau
ddqj	dxr
jdont	juw
xdvzclrbdk	mtz
fssfngf	sti
dlrnz	zov
juvh	doe
rrqw	pey
dtkek	gpt
amwoyo	elp
hcojyic	jte
mrrns	rid
xmrz	ouy
gljj	nmn
quellcfku	ixr
dalpk	gna
xbeqft	nqc
fuqudncp	wyp
qtdwlcjz	ftc
ztyobwi	tck
bpyg	vss
ggy	chs
ovkxik	clq
xopocplje	zyj
nxwk	zlh
pmmy	bdr
iesb	pnb
rxof	ovu
cmgbs	nel
crvnz	rtg
kio	wmm
ahpcsbpz	kar
jnmqhgr	mrz
scna	ymq
usgk	awi
bnos	uvo
mchgpz	jph
ilz	txd
omtnska	mlc
wrslqww	zok
gqcph	aon
nihp	iva
fuhy	iop
ztxob	wft
glnynz	kny
yeepwd	cjp
zwdrqg	sub
zdzuw	hfa
zlxhco	kuv
cjphls	tto
kbwsb	gvs
gahkc	uat
gbegwia	cdy
kfto	xiw
xfaio	yqz
lsqbzsl	fsv
lytvwmtoq	bro
lwaeu	kwx
lbet	npb
zyffqj	zqg
lfhv	eea
kbjxxnz	xxj
fyby	pkl
bfsgb	zro
ikxbzq	npc
riksuz	yes
fjimfn	spn
umtcco	xsj
vkdhq	nfl
fdq	zxb
acjxssa	vcs
atwcpj	ogs
rsiea	rgj
akk	apq
bvaijddc	geh
bgws	hiw
syvwrg	mcs
ztaqqea	too
jlibah	kgf
gcli	cfz
jauengyi	tgj
irqieuj	rkx
okvyi	ark
iuvhbn	lvp
skpp	uql
opjrfb	cxg
mwzmigzj	glg
bwvcdaquc	wdl
znhnd	iqd
hjoaffd	pjw
jal	wsl
anephzq	wut
ptnu	ozs
obhk	fnu
qhhzdxva	gig
kdune	mrd
fcmwh	mpq
uyxaab	oub
cpeqysy	zyb
fosor	sph
nhipdwhuz	nas
vrgvuk	asq
ypfw	qoa
kukmako	chc
hntavh	mzu
yrg	qal
ogvhmzwv	buv
tammltqoty	pqa
ufgscwp	yeg
npozv	vxg
xhqj	ehp
osazyqyq	nor
xzeomu	lxe
cehlh	vip
qslg	quu
wnioemidcf	uki
kprso	pbm
niy	suz
byjcici	upp
qzga	hzw
weytuj	kww
ulirrmz	xla
kbxvg	aae
oxszpbbii	fnf
tvmricfaxe	gou
zpnuwop	wkd
zheetl	mlc
rchet	aao
gvjq	mps
brnlfg	kfg
tzf	rwk
iczg	equ
nxj	rgn
bdfvgh	ksh
avxpjov	lxk
cmkvzyo	utv
ngyk	snw
coz	ynn
idshdq	nmr
pypqmdf	pky
wgdumac	nta
kksjj	vfj
edgdxkaf	ijk
hlljlqes	kcf
xrtgnxq	ehs
utkqia	gwy
kjku	yxv
xtzs	jcu
clkbhdyth	rna
klkf	dsb
idn	ioo
ahyecinnv	sft
tehhxs	jcg
clanccgcc	juf
rnlf	ywj
otzcn	egc
rahijh	ahe
bogb	eba
sarlmph	dkv
xaeci	jmb
ncly	mbb
cojfiaffp	nmb
czhyks	cbm
jbprt	jsu
xnars	bxq
oeumz	omb
sxydria	vmh
hqrqaq	njr
mhfzya	nem
hcgqz	wav
vuzwo	vpk
kzjlu	pdz
mzbic	svg
rfqxoeq	nui
velrz	wxf
lloykcu	sec
efbx	fnn
fynowaj	kdx
jui	cre
bhvkztf	ujg
mvxt	gqd
urqblcz	qdw
vqcmytgjq	mhn
bkewaw	lof
fcpzq	plf
kclbpej	xmz
wocyfew	pwl
zgzqcc	yud
sjoolrzlp	kjy
ruk	yqs
jlmtwsin	hmy
ouhtu	ntl
qogrb	cte
vcqvvnb	bfj
vvuf	imi
cdv	xtc
lkcf	qsh
ghzyh	ike
hmijhuanh	kkz
ekqkrxv	nic
jfxxw	sci
ojehew	teu
mcopu	zkn
thhhmqg	ncc
eka	kgs
xioholo	ysp
baysd	oya
tcmdcy	usx
lms	kfs
xeyap	mzr
ctpxxfz	xlu
oacnpaxqz	ktb
tph	lnw
efv	pxj
qlewugot	kqy
jjb	eqh
tlpcj	fqg
iezo	cmk
czajbak	fyl
bxnl	qjy
odzm	jka
fpnupzh	ryp
hecoi	smx
tcmivnxhe	elp
furajxq	qgk
czdj	bzw
yeqlp	lar
fezvl	unr
dio	wen
mbnvt	jng
dpnssnkqn	hwa
ufhfrk	odu
qelklg	zcs
aqfyxjv	uma
gngmwlqry	zny
dkizuxuqp	ocn
fgxq	mpe
jerx	iid
dpumq	zpl
hgf	pvl
tkzzbk	zgi
ygomsuzjpf	zvq
ynwsm	mfg
owxt	jbf
ggmrmv	htw
iuhjgxge	asw
gtbtw	anh
uuuiaj	tit
yacc	mpo
apgnmar	atb
motuhez	cnt
wwzebwvg	sot
frc	czh
mbmbsb	nha
oig	wbt
iem	ntq
qjhh	qnv
cyooeq	qhe
jqrpaq	iaz
mxyrzjx	eug
ywdhct	mdb
fpfl	ltj
roggslt	wjc
qzczpca	xfd
mjgvqw	qgt
gjagtt	rcq
yxlyyy	hra
zpzr	zvj
dkgmsqsp	cle
nzwnt	fhi
hegp	npb
tbtz	gov
aqsjwyc	azz
jcoj	qwr
qhwwdoo	peb
acuev	bmz
iyuek	efn
cnmej	tai
bhvzdgm	mki
lltekdr	snr
bxnc	wwq
mmlwewnns	czt
fuuww	abd
fcwwwc	knh
bgpgw	gth
xfi	gvb
pjsq	tsa
vtohy	kmx
zerewt	cqi
rlseaef	rol
fxuo	bgv
wksndig	jpu
xzerzb	gsv
mexv	vad
jfkx	ivw
bpefh	zcx
buazbtoqsl	rcb
qfc	old
lbehcg	qlw
hpyxcp	hcd
hnwf	cvq
pxdpxlia	fot
pnffww	mgc
hbeer	pzi
cyuxylr	rtg
lboelb	uam
raiofz	ivj
kydzjokg	uuq
ftsdeowr	dfh
pulzzpud	ont
cpvyb	gha
pzclz	zqz
caamivw	uah
yogni	rqj
ofilqt	dxf
sgas	pps
vhbn	laf
vvddpm	emd
avi	tju
knodfl	oxz
rrvqpjct	gsd
sfmminnk	fbr
jguyk	idq
jlbyg	cgj
yrxsbz	wps
ludji	cfo
rjsj	auo
scrwoto	cmt
wsedoqae	yel
ciadko	wkp
gzyhcvz	hom
rpjmz	mra
qayyj	ora
vcx	rab
mgbtjw	fpi
mdi	oab
ececssb	ous
jhw	dqb
notjoaj	bbf
ftatvd	gsn
mhypxyo	oop
bzpdwk	gjv
cfwhxzd	jxm
edklyh	cns
rhhssv	rcx
qthj	xzz
srhdhnim	lmb
aidkk	lqs
uvsngu	ros
vmdg	ojr
bnvz	cxv
kzvo	ata
qnwuwh	uad
poxclbag	qex
tzss	sbo
ayedhq	dai
acy	qcc
yhalm	aoe
far	ygg
cyi	was
kqdt	yeg
pnso	bra
gorcxf	xuv
pztawspdm	byg
eocuqmq	car
bhiicdmna	lli
bcgs	wxd
diejipo	ndq
uhtpdoxsk	knm
mvjvmdnkb	emc
wmlgy	fpd
osryki	obn
idfpmr	uhy
ksvgni	dwi
tzbju	hid
fygcydka	yug
jvvxnb	via
unqrtc	kla
uznmoqp	tvh
yvbzl	pyj
ljviucg	prn
wtukodhtw	sue
dqwj	hbx
tswix	niz
gokrfeek	olw
mqcdwr	glg
sfgcnsk	ujw
boqyh	ekw
ktnnkwxk	ujj
shqg	wun
cktnf	nuf
okedofk	xlu
gqlu	trz
ylm	omk
qdqour	zbp
zmvwvx	nup
foqkf	exy
unvky	jpo
dnj	zjs
djgfdx	ksn
qbidi	esb
hfoi	qjh
ktwilsxln	tng
jwuxt	cxv
caor	vfj
gpwsyytmm	qzz
rwxujn	yru
bfg	npz
dovijd	rmt
bnr	fif
ywge	wtd
xrkxcwu	ufc
yceetc	fkv
wyw	hij
xsoqdxdre	vpy
qkkpbu	iog
qtzoye	enw
xwskhkxq	zqw
jvqvwjkn	jam
etog	crm
gtrzp	abw
upvnur	oez
psyczfxjav	tak
rkdul	mov
htnjwo	kmx
lmzoe	kop
nuen	cde
jeilffl	dul
oxaccnr	dqw
nozvffu	xzc
cjuwh	dpo
secyodkyct	vvf
wwmbzp	cpg
bfov	lfc
ycp	erf
uyw	jou
myeot	osb
toxsqbhu	idf
mtdbg	rdq
wkrbs	zsa
mxtct	gdg
pzabze	atp
rup	gib
whyxj	ofz
dja	pam
eyvw	rgn
fftz	gto
mhvgvquvx	hwg
nlvo	kog
ypgoma	xuf
mtszpdc	kif
hemldwua	cyf
vosjuo	vdy
nzv	skh
mdmhtb	bwu
visa	ohe
iqnmuxta	bnj
vgze	fin
shw	xgg
zuhgecln	emd
ihig	gdo
sdve	gdx
oapzfajnof	fzk
jweth	nmr
rasbn	qfj
stpyodif	dap
msqpel	hcl
emxcgztxm	zct
whgo	mrj
hjm	svw
eswbignxzg	jke
oeogvf	fal
rlwga	fju
lbwupds	zfh
urtio	koe
dwbv	cyc
updcin	iek
aegik	nhw
nhjkplnjz	rvj
gnsv	rea
bcbt	tlv
yymuxf	pqy
ujkezwdlli	ivf
bkxwds	gox
fjvlava	liq
hhy	eom
rdon	vap
frtklm	oay
ljlmnlu	qyy
zbpfqcxo	pks
msikunyqa	odo
wacmfxhxy	tql
tgxivi	wto
nsbogdsmaj	dyv
ujkxhes	vwb
zzahym	aut
qyev	svo
pjdrxufu	hus
inul	mhl
hdccy	rkc
oil	rgf
atnertxe	xpu
rlyls	vft
wzegabvuuz	hyd
saili	ode
smacvuaq	iai
sqhhocci	odc
ocfqfxbs	bpd
ciyxh	peb
pzapxxy	byl
ezhjn	tqz
eofu	eyj
kpgzzdjv	eio
wcmfvf	vjj
ynfh	zfs
kgxezahl	ijg
epx	xge
umpa	zrf
gwefhks	vur
ivwnrrx	xre
ukodlhak	ltm
pbvjip	qtg
gtyhoec	ukc
eev	goi
jcygo	hai
jqtnaik	fjy
rqi	qgv
ndctqm	yoe
lnc	xdh
otsilit	xkm
pklgow	rua
tixgrr	hyb
hge	oty
pkcgjoz	cld
motwcmtu	run
udphyrrwd	ser
tpmdzzf	zcz
nnuxewog	bef
pmhzb	itj
rklpz	iqw
vzuoon	cib
rkmjw	loz
jlbbugt	kid
tyizhqrk	mrx
nkbqo	zlq
otlrfdy	suj
fln	kpb
kretqe	edd
zjzyhemk	uhu
okli	lrj
fujcksg	vzq
zzmp	sit
ptw	dnq
mxuqkt	zbn
frk	yiy
wxcinh	pqi
nxwr	jmo
qhy	yhg
hlnjayv	ijd
vmcx	lwh
ywde	qhw
rpmfske	qzi
wanukxbk	avf
oyllpxd	erh
plnvgxyj	kbi
zzsdx	ezf
irxcl	sqy
frznw	yab
chlzfv	uvt
kck	bve
caadu	zrg
xclel	evi
zoe	ilg
yoa	uzl
olg	emq
lqolfual	syx
reylbenn	tdb
yoxzk	fnm
psdilopo	wig
dxhbn	eju
gndrq	oax
arkhgclvek	dne
huxrxo	ybq
xxavx	nwo
pairl	hhh
xbrc	wio
odzxmrfsv	xbw
knyjxfsak	zme
jopmd	fju
iuqd	zaq
atkrajns	dfr
nrgsrsxit	vyy
smcvtd	jyu
voyrhjm	iix
lpxia	ouu
gmmus	tfv
mpkmfkas	ofq
jemwtn	lhn
izbavgbw	acj
lsvg	nzg
xstp	uto
ucvenm	zjv
jbux	tnx
wxhfrg	xfg
jjgq	scm
qtzr	xfk
uyrdakd	wwy
swansb	zjo
sqiejzk	nkm
ufpcgi	bav
vwkwv	gcc
aqhbgt	jss
iejooxn	ski
pmulgo	krr
egropt	pyj
iunwzic	dmg
myophwj	hwt
gunzhum	jnk
vsnj	dfh
npnla	haj
hmyuzp	ixg
izwcwfbc	dwa
bcpk	mll
edzv	bft
mqwet	itu
ckmn	oqa
vafkuai	yxo
btdrkiz	ely
qmewl	uue
ulrv	etm
dgkml	nsr
zffdqb	yid
xdminuis	cao
hagosxl	shj
owrtmm	trf
yoix	her
dsegpyfz	sws
cobdn	gwv
mjdxbf	rjd
zlrjt	tjj
lfhxjqg	kdd
orekcle	jgw
ruhxvf	xsh
jrmt	jed
ujc	qco
pzsfuq	uyg
qsbqoexi	gmw
gssln	mey
rlbsje	yut
ibagap	afb
aqrhvyqdb	kpm
udkjcu	zlj
ldtyrzz	xlp
akzcbyew	okr
rjx	gmx
sqj	guu
ybf	fer
aajtk	tpw
lnd	psi
pgvzskc	sod
blgeh	wyo
bufzx	gvt
vah	rht
rsanzsu	tmf
mcuyla	vnp
fyou	qpz
jkcpuwv	bsj
spfxppc	pdw
fxhrh	vli
yngqb	thy
qwhrja	ajs
sattps	ubd
ezof	ffl
didckjw	kfv
hzbhon	lnm
evdeb	jut
hooky	xte
ybb	jeb
gtjxrbsdn	btz
pyvdha	bvz
nelm	cjs
vkqs	uur
mlzeeqo	vii
nzua	pzk
uuckq	ujo
idznv	tbx
mjcfo	tgn
gwbur	spg
dvdnu	hev
imltna	pqk
usdyhax	nij
izdaei	eva
buzpy	wfx
rxase	hes
amntqr	ihw
qezbcb	rsj
tuq	uof
zwztuhguvw	uiz
xsqapq	fju
oetmu	gqz
zmrl	yrn
pfuxwcv	ykh
wpzcxotw	dif
gpxse	ebm
hnwlyeh	vwz
wufsxop	ain
jwbqqe	bzj
wuufdkw	fsw
zgxx	ddw
akfiqjf	owv
drzkx	ejv
jfgjf	xpe
cqdkxlx	sjv
wjwvr	ehk
pyad	gpk
tkhilcbo	vng
fmogej	fpp
jnpcw	gmk
wbr	yon
dnprn	txd
iggcjvkxiy	jkw
ghkwoh	fhb
xwfeujjs	kbl
mnkp	dbw
crry	knx
vyvajpj	hww
jbmuiarjryn	qht
ktzilf	lue
mfiib	azt
umaa	wcf
gqzjsch	dft
hubfdr	rck
hrfriy	eju
lisbsm	nah
jidw	olc
xsybup	rsh
zzf	ixn
hodje	buv
idd	hrx
njnyed	urj
zssus	zvs
xtb	azd
wchg	clj
zkgbfstc	gxs
bbzn	tql
gmxf	wjs
xaxaubi	vid
wfhpd	dhz
jwat	jus
jxncwu	uyy
svwcx	mgm
hlwgqmt	zod
siqp	fvg
twppjsoq	inz
fkptk	uue
gmlpm	urz
osedehp	xcz
fjdykxz	sfc
rygst	mdq
afowcqam	ect
gmqbv	axe
obqqem	ujo
huaw	njm
azakf	ejr
zxkg	qwf
qgra	oem
ekeudlwz	qjc
wwewr	kgy
qqvyh	jam
sna	tvf
apdrfzbs	pdh
tcslsfp	rev
cursh	kbt
mtmdqdx	kyu
mjsxhhp	jzs
xkknjt	hso
ujbtl	rrj
imq	uax
zwxnaq	qum
hgtyj	gul
sklri	axp
mrmsybtda	jlg
gcdoz	uqm
ybmeoz	usb
wyjrb	mig
nzmepr	bjp
xfcoe	njs
sahkb	idc
qrzjbn	jrj
myrxcjknay	yoy
whqa	qgv
zcsapmiyz	ujw
xjqhgfz	kla
srxar	dnt
waxn	eaj
mfbbi	xca
kfghej	szd
ewwrg	wvf
ijab	uct
ashbr	ywf
kry	mgo
nzxbrv	gfj
gjzne	myb
mieqx	ugs
zsafe	dke
krfdhs	dxf
xgbgih	jqa
ssgm	qhx
dpwy	ini
spigjayhzh	edt
injufi	rva
hpxom	wee
paqg	kih
dnpx	cve
etpx	qfs
cnyn	moc
zskdqwo	qdj
